人类	全人类
人手	人员
劳力	劳动力
匹夫	个人
家伙	东西
每人	每位
该人	此人
人民	民
群众	大众
众人	人人
人海	人群
大家	大伙儿
们	辈
我	咱
老朽	老汉
小弟	兄弟
奴	妾
朕	孤
职	卑职
贫道	小道
我们	咱
老兄	仁兄
老弟	贤弟
大嫂	大姐
阁下	足下
陛下	主公
您老	你咯
你们	尔等
诸位	各位
他	她
他们	她们
自己	自家
别人	旁人
谁	哪个
某人	某
谁	孰
男人	男子
爷儿	爷们
先生	子
女人	女子
女流	女人家
少妇	婆娘
姑娘	少女
仕女	贵妇人
贱人	祸水
村姑	农家女
男女	士女
老人	老
老朽	风中之烛
老寿星	寿星
公公	爷爷青年
老奶奶	老太婆
老太太	老婆婆
老家伙	老糊涂
成年人	壮年人
老小	老少
青年人	小伙子
知识青年	知青
少年人	少年
芝兰	龙驹
婴儿	婴孩
宝宝	宝贝
儿童	孩童
妞	妮子
顽童	小淘气
男童	男孩儿
高个儿	高个子
细高挑儿	长子
矮子	矮个儿
胖子	大块头
瘦子	骨头架子
美女	美人
丑八怪	夜叉
麻子	麻脸
秃子	癞子
豁嘴	豁子
结巴	结子
居民	居者
市民	城里人
乡民	乡下人
船民	水上居民
侨民	侨
本国人	国人
外国人	外侨
洋鬼子	鬼子
外族人	外族
中国人	华人
本地人	当地人
村里人	全村人
外乡人	异乡人
同乡	老乡
职工	员工
职员	干部
公务员	勤务员
秘书	文牍
总务	庶务
会计	会计师
掮客	经纪人
从业员	营业员
列车员	乘务员
广播员	播音员
理发员	理发师
空姐	空中小姐
消防人	消防员
承运人	发运人
供给者	供应者
编选者	编委
勘察者	勘探者
工人	工
工匠	匠人
老师傅	师傅
壮工	小工
短工	零工
苦工	苦力
学徒工	徒工
木工	木匠
瓦工	泥工
石工	石匠
油漆工	漆工
花匠	园丁
画匠	画工
成衣匠	裁缝
鞋匠	皮匠
铁工	铁匠
海员	船员
领航员	引水员
船夫	船工
舵手	掌舵
驾驶员	司机
飞行员	航空员
宇航员	航天员
驭手	御手
操作员	操纵员
搬运工	挑夫
炊事员	厨师
火夫	司炉
邮递员	邮差
交通员	交通
联络员	联络官
门房	号房
服务员	招待员
堂倌	酒家
清洁工	清道夫
勤杂工	工友
农民	农夫
小农	老农
佃农	佃户
上中农	富裕中农
牧民	牧人
渔民	渔翁
猎手	猎人
樵夫	樵
饲养员	倌
羊倌	羊工
放牛郎	牛郎
马夫	马倌
屠夫	屠户
商人	商贩
商旅	行商
小贩	摊贩
客帮	客商
卖家	卖方
军官	武官
指挥员	指挥官
总司令	司令员
将领	将军
副将	偏将
虎将	猛将
老总	长官
将士	官兵
军人	武人
荣誉军人	荣军
边防军	戍边人
士兵	兵士
女兵	娘子军
士	军士
步兵	陆军
骑兵	轻骑
水兵	水师
侦察兵	侦察员
哨兵	卫兵
航空兵	空军
伞兵	空降兵
工兵	工程兵
号兵	司号员
警卫员	警卫
通信员	勤务兵
退伍兵	退伍军人
复员军人	转业军人
老兵	老红军
兵圣	战神
官军	官兵们
情报员	谍报员
敌特	敌探
译电员	分析员
警察	警
人民警察	民警
捕头	警长
侦探	暗探
看守	狱卒
行刑队	刽子手
审判员	审判员
检察官	检察员
律师	辩护律师
征稽	考稽
教师	老师
教官	教练
教养员	保育员
塾师	师傅
学生	生
门生	门下
高足	高徒
寄宿生	住读生
定向招生	委培生
学习者	学人
运动员	选手
裁判员	裁判
医生	医师
国医	中医
良医	名医
太医	御医
助产士	接生员
护士	看护
作者	笔者
执笔人	主笔
译者	翻译
记者	新闻记者
新闻工作者	新闻官
媒体	传媒
编辑	编者
总编辑	总编
创意者	创意人
演员	艺人
明星	影星
女演员	坤角儿
歌手	歌姬
主角	角儿
配角	班底
名角	名伶
生角	生
老生	须生
旦角儿	旦
青衣	正旦
彩旦	丑婆子
丑角	小丑
花脸	净角
大花脸	大面
二花脸	武二花
演职员	演职人员
表演家	表演艺术家
舞者	舞星
知名演员	名演员
琴师	乐师
鼓师	鼓手
号手	吹鼓手
演奏者	演奏员
剧团人员	剧中人
编剧	剧作者
文艺工作者	艺术工作者
模特	模特儿
阴阳家	阴阳生
魔法师	魔术师
巫师	巫神
女巫	巫婆
劳动者	生产者
无产者	无产阶级
实施者	执行者
奴隶	农奴
小市民	城市贫民
上访者	来访者
接访	受访者
投保人	股民
候选人	候选者
选民	选择者
跟随者	追随者
反驳者	反对者
抗议者	示威者
仆人	佣人
男仆	苍头
童仆	家童
女仆	仆妇
婢女	婢
奶妈	奶娘
奴才	小人
仆从	长随
侍从	扈从
随从	随员
封建主	领主
地主	二地主
东家	老爷
农奴主	奴隶主
士绅	绅士
豪绅	劣绅
资本家	资产阶级
老板	财东
店主	店家
经营者	纳税人
出资人	投资人
皇帝	帝
女皇	女王
暴君	桀纣
皇后	王后
妃子	贵妃
贵人	后宫
皇室	王室
太后	皇太后
太子	皇太子
王子	皇子
公主	郡主
王孙	金枝玉叶
王公	公爵
贵族	万户侯
权贵	显贵
太监	宦官
宫女	宫娥
女官	女史
官吏	臣子
大臣	重臣
芝麻官	知府
忠臣	忠良
奸臣	坏官
清官	青天
赃官	贪官
差役	公差
宰相	丞相
秀才	生员
幕宾	幕僚
门客	门下
使者	使节
领袖	元首
头领	头脑
控制者	操纵者
领导	负责人
领队	总指挥
监工	工头
创建者	创立者
创业者	创业人
策划人	策划者
首倡者	首创者
倡导者	倡议者
主办人	主办者
经办人	经办人员
名人	名流
要人	要员
隐士	逸民
小人物	老百姓
健康人	好人
病人	病家
植物人	瘫子
疯子	疯人
伤员	伤号
残废	残缺
跛子	瘸子
驼子	驼背
瞎子	盲人
哑巴	哑子
孕妇	妊妇
鳏寡孤独	孤寡
鳏夫	孤老
寡妇	孀妇
孤	孤儿
孤魂	孤鬼
光杆儿	光杆司令
单身汉	独身汉
富翁	财主
阔少	大少爷
债主	债权人
吸血鬼	寄生虫
穷人	穷鬼
乞丐	乞
债户	负债人
帮扶户	保户
闲杂人员	无聊者
幸运儿	福人
红人	宠儿
可怜虫	小可怜儿
无辜	俎上肉
出气筒	受气包
瓮中之鳖	网中之鱼
众矢之的	过街老鼠
屈死鬼	冤魂
被害人	受害人
当事人	当事者
冤大头	大头
替身	替死鬼
祸胎	祸根
火主	火头
死难者	罹难者
难民	难胞
灾民	流民
逃亡者	逃犯
流浪汉	游民
败兵	乱兵
俘虏	俘
人质	质子
违反者	违者
不合格者	不符合条件者
输家	失败者
旅客	客人
过路人	过客
游人	游客
乘客	司乘人员
参观者	观赏者
亲戚	亲属
外戚	远房
血亲	宗亲
姻亲	亲家
眷属	亲属
女眷	内眷
侨眷	侨属
曾祖	曾祖父
曾祖母	老奶奶
祖父	太爷
祖母	奶奶
叔祖	叔公
叔祖母	叔婆
外祖父	外公
外祖母	外婆
父	父亲
令尊	老太爷
继父	后爹
养父	义父
先父	先人
母	母亲
令堂	老太太
家母	老母
庶母	姨娘
继母	后母
养母	义母
父母	双亲
保护者	保护人
父子	爷儿俩
伯父	伯
伯母	大妈
叔父	叔
叔母	婶
姑父	姑夫
姑母	姑
姨父	姨夫
姨母	姨
舅父	舅
舅母	舅妈
公婆	姑舅
公公	公
婆婆	婆母
岳父	岳丈
岳母	丈母
夫	丈夫
老伴	老头子
郎	郎君
妻	妻子
内人	拙荆
嫂夫人	尊夫人
发妻	元配
填房	继配
妾	小
夫妻	夫妇
鸳鸯	鸾凤
配偶	偶
兄	兄长
长兄	大哥
家兄	胞兄
弟	弟弟
堂哥哥	堂兄
师哥	师兄
兄弟	弟兄
同胞	亲兄弟
表兄弟	老表
姐	阿姐
妹	阿妹
姐妹	姊妹
连襟	连袂
嫂子	嫂
弟妇	弟妹
姐夫	姊夫
妹夫	妹婿
妻舅	舅子
内兄	大舅子
内弟	小舅子
姑	姑娘
大姑	大姑子
小姑	小姑子
大姨	大姨子
子	儿子
养子	义子
继子	继嗣
小儿	犬子
令郎	少爷
女	女儿
令爱	千金
养女	义女
子女	儿女
心肝	宝贝
独子	独生子
双胞胎	孪生子
混血儿	混血种
媳妇	媳
女婿	婿
佳婿	乘龙快婿
赘婿	招女婿
姑老爷	姑爷
侄	侄子
侄女	表侄女
甥	外甥
甥女	外甥女
孙	孙子
曾孙	重孙
曾孙女	重孙女
外孙	外孙子
鼻祖	始祖
创始人	开山
前人	先驱
引进者	推荐者
今人	时人
一代人	当代人
后人	后代
古人	原人
祖宗	祖上
长辈	长上
父辈	大伯
大妈	大娘
侪	同龄人
晚辈	晚
子孙	子嗣
受益者	受益人
朋友	友人
好友	挚友
旧交	旧友
新交	新知
难友	患难之交
益友	诤友
世交	世谊
诸亲好友	亲友
教友	校友
恩人	恩公
仇人	敌人
死敌	死对头
外敌	外寇
残敌	穷寇
夙仇	夙敌
对手	对方
自己人	知心人
外人	局外人
邻居	邻人
一伙	一伙子
一路货	狐群狗党
同伴	同伙
伙计	搭档
同道	同调
合作者	合作方
把兄弟	拜把兄弟
同学	同窗
学长	学兄
同事	同人
同僚	袍泽
主人	主
主妇	管家婆
寄主	宿主
客人	宾客
贵宾	上宾
男宾	男客
宾主	主客
接受方	接受者
顾客	主顾
购买者	买客
消费群	购买群
成员	分子
人马	队伍
党徒	党羽
私党	死党
上级	上司
下级	部下
平级	同级
助手	副手
参谋	顾问
靠山	后台
师傅	师父
师母	师娘
徒弟	徒
物主	主人
屋主	房东
收信人	接收者
寄卡人	寄信人
主持人	主席
司仪	打理
与会者	到会者
演讲者	讲话者
专人	专差
特派员	全权代表
钦差大臣	钦差
代表	代办
代言人	发言人
见证人	见证
保证人	保人
中间人	中人
调解人	调人
仲裁人	鉴定者
证婚	证婚人
被告人	被上诉人
举报者	举报人
介绍人	引线人
媒人	媒介
男傧相	伴郎
伴娘	喜娘
中介	中介人
新郎	新人
新娘	新娘子
情人	情侣
男朋友	情郎
女朋友	女友
姘头	相好
情夫	姘夫
情妇	姘妇
王八	乌龟
英雄	豪杰
有志者	有志之士
硬汉	硬骨头
烈士	先烈
勇士	武士
侠客	侠
懦夫	胆小鬼
懒汉	懒虫
好人	明人
君子	高人
圣贤	圣
先贤	先哲
元老	长者
坏人	歹人
小人	小丑
土棍	地痞
恶霸	霸
豪强	豪门
豺狼	魔鬼
暴徒	强暴
奸邪	奸人
野心家	奸雄
独裁者	独夫
老好人	好人
凶人	凶神
泼妇	悍妇
伪君子	假道学
滑头	油子
吝啬鬼	守财奴
市侩	势利眼
造假者	弄虚作假者
孝子	孝子贤孙
逆子	孽障
贞妇	烈女
荡妇	淫妇
骚货	妖精
浪子	败家子
色鬼	色情狂
老顽固	死顽固
学究	腐儒
急性子	直性子
炮筒子	大炮
慢郎中	慢性子
话匣子	碎嘴子
应声虫	尾巴
馋嘴	馋猫子
夜游神	夜猫子
怪人	怪物
知识分子	文化人
文弱书生	白面书生
学者	鸿儒
作家	大作家
诗人	词人
诗仙	诗圣
画家	画师
寒士	措大
书呆子	老夫子
文痞	文侩
文盲	睁眼瞎子
大老粗	土包子
内行	行家
专家	专门家
识途老马	宿将
骨干	基干
外行	门外汉
生手	新手
俊杰	豪杰
人杰	翘楚
人才	材
女将	巾帼英雄
能手	能人
多面手	通才
新秀	后起之秀
庸中佼佼	强者
高才生	七步之才
聪明人	智者
明眼人	有识之士
机灵鬼	猴儿
笨伯	笨蛋
饭桶	草包
傻子	傻瓜
庸人	庸才
绣花枕头	纸老虎
半瓶醋	二百五
浑蛋	混蛋
活宝	宝贝
糊涂虫	糊涂蛋
模范	标兵
劳模	劳动模范
先锋	急先锋
功臣	元勋
爱好者	发烧友
教徒	信徒
佛	菩萨
沙门	僧尼
僧徒	僧侣
尼姑	尼
禅师	活佛
住持	方丈
道教徒	道徒
道士	法师
伊斯兰教徒	回教徒
天主教徒	天主
枢机主教	红衣主教
神甫	神父
耶稣教徒	基督徒
反动派	反革命
反派	反面人物
匪帮	匪徒
刽子手	屠夫
战争贩子	战争狂人
叛徒	内奸
卖国贼	国贼
奸贼	贼
儿皇帝	傀儡
罪犯	罪人
死囚	死刑犯
凶犯	凶手
主犯	要犯
从犯	同谋犯
逃犯	在逃犯
教唆犯	教唆者
窝主	窝家
嫌疑人	疑凶
强盗	盗
匪首	盗魁
草寇	绿林
殖民者	殖民主义者
窃贼	贼
惯贼	惯窃
盗码者	黑客
剽窃者	盗卖者
侠盗	家贼
入侵者	征服者
流氓	痞子
二流子	浪子
骗子	拐子
投机商	奸商
毒贩	毒枭
走狗	狗腿子
赌徒	赌棍
酒徒	大户
烟鬼	隐君子
妓女	妓
艺妓	摇钱树
暗娼	私娼
男妓	相公
鸨母	鸨儿
龟奴	乌龟
嫖客	孤老
物	实物
物质	质
占有物	专有物
物体	体
整体	通体
晶体	晶
水晶体	晶状体
绝缘体	非导体
机体	有机体
等价物	同系物
附属物	附着物
样片	抽样
硝酸	王水
醋酸	乙酸
烧碱	火碱
碳酸钠	大苏打
硫酸铜	胆矾
明矾	白矾
硅	单晶硅
硫磺	硫
蛋白胨	蛋白质
正离子	阳离子
等离子	等离子体
生物	底栖生物
动物	众生
温血动物	常温动物
冷血动物	变温动物
节肢动物	甲壳动物
线形动物	圆形动物
植物	植被
阳性植物	喜光植物
作物	农作物
大秋作物	晚秋作物
越冬作物	过冬作物
青苗	青
微生物	菌物
动植物	飞潜动植
物品	品
必需品	用品
给养	补给
摆设	陈设
纪念品	纪念物
奖品	奖
杂物	杂品
古物	老古董
遗物	旧物
失物	遗
证物	信物
赝品	赝鼎
抵押品	当头
违禁品	禁制品
赃物	赃
易燃物品	易燃物
工件	作件
部件	元件
备件	附件
货物	商品
百货	小百货
下脚货	残货
国货	国产货
进口货	来路货
冷货	冷冻货
私货	黑货
优质品	优等品
产品	出品
粗制品	半制品
副品	次品
仿制品	复制品
试用品	试制品
出产	物产
水产	渔产
土产	土特产
器具	器物
器皿	容器
酒器	酒具
喷头	莲蓬头
锚	铁锚
电烙铁	烙铁
电熨斗	熨斗
消火栓	消防栓
设备	装置
物资	战略物资
材料	料
原料	原材料
香料	香
生活资料	消费资料
柴米油盐	油盐酱醋
家具	家电
礼品	礼物
贺礼	贺仪
薄礼	小意思
聘礼	彩礼
贡品	贡
祭礼	赙仪
嫁妆	妆奁
祭品	贡品
宝物	宝贝
宝	珍玩
宝藏	矿藏
传家宝	家珍
废物	废料
矿物	矿产
担子	挑子
包裹	包袱
它	她
什么	那些
锭	砖
块	丁
粉	粉末
沙	沙子
点	点子
粒	豆子
堆	垛
把	把子
球	团
轮	饼
片	片子
箔	膜
草屑	木屑
筒	管
洞	窍
棒	棍
焊条	焊丝
钩	钩子
鱼钩	渔钩
网	网络
蜘蛛网	蛛网
波	浪
表面波	音波
顶	颠
端	头
鸡冠	鸡冠子
炕头	床头
底	根
末尾	末梢
边	沿
角	棱角
面	面子
正	正面
外表	外边
外壳	壳
反面	背面
侧面	侧
南侧	南端
东侧	东端
北侧	北端
外围	外层
脊	棱
身	体
膛	腹
帮	壁
颈	脖
骨架	骨子
框	框子
盖	盖子
塞	塞子
杆	梗
柄	托
把	把手
拉手	扳手
刀把	刀柄
嘴	门
座	座子
脚	腿
翼	翅
挡	栅
心	芯
宇宙	天体
星辰	星斗
星座	座
银河	天河
金星	太白星
火星	荧惑
木星	岁星
土星	镇星
织女星	织女
牵牛星	牵牛
北斗星	斗
北极星	北辰
彗星	扫帚星
老人星	寿星
流星	贼星
太阳	阳
朝阳	旭
夕阳	斜阳
骄阳	烈日
太阳黑子	黑子
月亮	月球
朔月	新月
新月	月牙
满月	望月
皎月	皓月
日月	大明
地球	地
寰球	寰宇
陆地	大陆
低地	洼地
荒地	沙荒
生荒	生地
盐碱地	碱地
雪域	雪地
原野	旷野
平原	平地
草原	草地
淤地	沼泽
沙漠	漠
岛屿	岛
沙洲	三角洲
滩	沙滩
岸	岸边
山	山脊
青山	苍山
高山	岳
山冈	山包
土山	丘
峦	峰峦
山顶	山头
山脚	山麓
山脊	山梁
山谷	谷
山崖	崖
童山	秃岭
山间	山野
西北麓	北麓
坡	斜坡
山坡	阪
缓坡	慢坡
荒山坡	荒坡
海洋	大海
远洋	重洋
洋流	海流
大陆架	陆棚
内海	内陆海
濒海	海边
江河	江
小河	浜
护城河	城池
岔流	汊流
主流	干流
支流	港
河床	河道
河曲	流觞曲水
巨流	洪流
急流	激流
暗流	伏流
溪涧	山涧
水沟	河沟
湖泊	湖
咸水湖	盐湖
池塘	池沼
粪池	化粪池
泥坑	泥潭
潭	潭水
湖泽	湖沼
泉水	泉
喷泉	飞泉
温泉	汤泉
瀑布	飞瀑
废墟	瓦砾
雨	雨水
雨点	雨脚
小雨	毛毛雨
大雨	豪雨
骤雨	暴雨
阵雨	雷阵雨
霖雨	霖
黄梅雨	梅雨
喜雨	甘雨
雪	雪花
粒雪	雪球
雹	冰雹
冰	冰凌
冰锥	冰柱
冰块	冰碴
大风	疾风
飓风	台风
微风	软风
清风	雄风
和风	熏风
寒风	阴风
热风	焚风
东风	谷风
南风	熏风
西风	大风
北风	凉风
西南风	凉风
逆风	打头风
旋风	羊角
信风	贸易风
狂风暴雨	暴风骤雨
凄风苦雨	苦雨凄风
过堂风	穿堂风
沙尘暴	沙暴
晚风	夜风
云	云彩
云气	霭
阴云	彤云
彩云	云霞
庆云	祥云
露	露水
严霜	冷霜
虹	彩虹
副虹	霓
霞	彤云
烟	烟雾
雾	雾气
云雾	烟霭
雷	霹雳
炸雷	焦雷
闪电	电
潮汛	潮信
流水	清流
洪水	洪流
深渊	渊
积水	沥水
开水	滚水
生水	凉水
泔水	米泔水
水滴	水珠
培养液	营养液
春水	绿水
汁	汁液
浆	浆液
泡	泡沫
水泡	沤
卵泡	气泡
波浪	波
大浪	澜
涟漪	鳞波
漩涡	涡流
野火	天火
篝火	营火
磷火	鬼火
火焰	火苗
外焰	氧化焰
内焰	还原焰
烈火	大火
星火	微火
烟火	焰火
烽火	烽烟
光	光线
日光	阳光
曙光	晨光
落照	残照
月光	月色
灯光	灯火
白炽	白热
红外线	红外光
紫外线	紫外光
偏光	偏振光
影	影子
人影儿	身影
背影	后影
电	电老虎
正电	阳电
负电	阴电
感生电流	感应电流
电波	电磁波
无线电波	高频电波
磁共振	核磁共振
气	气体
空气	大气
冷气	凉气
暖气	热气
氧气	氧
氢气	氢
氮气	氮
氯气	氯
氨气	氨
碳酸气	碳酐
沼气	甲烷
电石气	乙炔
毒气	毒瓦斯
水蒸气	蒸气
氩气	氩
氟化氢	氟利昂
颜色	色
淡色	素色
基色	原色
冷色	寒色
补色	对比色
图案色	广告色
银灰	银灰色
气息	气味
味道	滋味
回味	余味
声音	声响
乐音	乐声
噪音	噪声
回声	回响
标准音	国音
元音	母音
辅音	子音
爆发音	破裂音
擦音	摩擦音
齿唇音	唇齿音
舌根音	舌面后音
翘舌音	卷舌音
字音	字
话音	口音
方音	口音
音节	音缀
叮当作响	叮当
足音	脚步声
喊叫声	叫声
赞扬声	喝彩声
鞭炮声	爆竹声
问候声	祝福声
无息	无声无息
大声	高声
低声	悄声
音调	声调
字调	四声
阴平	第一声
阳平	第二声
上声	第三声
去声	第四声
节拍	拍子
灰尘	灰
灰烬	烬
浮土	浮尘
征尘	风尘
烟尘	尘烟
污垢	污
泥垢	尘垢
纹路	纹
皱纹	皱
指纹	螺纹
痕迹	印痕
手印	手模
踪迹	踪
足迹	脚印
血迹	血印
油迹	油渍
字迹	笔迹
汗斑	汗碱
点	点子
道子	道
伤痕	创痕
瘢痕	瘢
裂痕	裂璺
车辙	轨辙
树木	树
果树	果木
树林	林
树行子	林带
松林	松树
海松	红松
杉	杉木
冷杉	枞
桧	刺柏
毛白杨	响杨
柳	杨柳
河柳	旱柳
雪柳	稻树
蒲柳	水杨
红柳	三春柳
梧桐	梧
悬铃木	法国梧桐
香橼	枸橼
苏铁	铁树
椴树	河北杨
椴	菩提树
栗	板栗
楮	构
栎	柞树
槲栎	槲寄生
檀	青檀
棕榈	棕树
三角枫	桠枫
枫	枫树
降香	木香
棠梨	棠
山桐子	椅
珙桐	空桐树
棘	酸枣树
洋槐	刺槐
泡桐	桐
枳	枸橘
荆	荆棘
橡胶树	橡
樟	樟木
杨树	小叶杨
翠柏丛	古柏
榕树	高山榕
灌木	灌木丛
榆树	榔榆
娑罗树	娑罗双树
桦树	白桦树
槐树	国槐
柳杉	南洋杉
常青树	长青树
椰林	椰树林
果木林	果林
幽林	林莽
栀	金栀
竹子	竹
毛竹	南竹
观音竹	凤凰竹
紫竹	黑竹
斑竹	湘妃竹
箬竹	箬
竹篾	篾青
竹笋	毛笋
花	葩
牡丹	国花
菊花	菊
荷花	荷
兰花	兰
珠兰	金粟兰
睡莲	子午莲
唐菖蒲	剑兰
梅花	梅
紫薇	满堂红
木兰	木笔
木芙蓉	木莲
山茶	茶花
合欢	马缨花
仙人球	仙人掌
腊梅	黄梅
朱槿	扶桑
杜鹃	映山红
月季	月月红
丁香	紫丁香
蔷薇	野蔷薇
凤仙花	指甲花
水仙花	凌波仙子
凌霄花	紫葳
紫茉莉	草茉莉
牵牛	喇叭花
翠菊	江西腊
大丽花	西番莲
油菜花	黄花
紫藤	藤萝
三色堇	蝴蝶花
天竺葵	洋绣球
百合花	百合
茉莉	茉莉花
鲜花丛	花海
山丹丹花	山丹
郁金	郁金香
花卉	花草
奇花异卉	名花异草
草	荐
草丛	草莽
杂草	荒草
蓬	飞蓬
茅	白茅
蒿子	蒿
沿阶草	绣墩草
鹅观草	鹅冠草
青蒿	香蒿
藜	莱
浮萍	水萍
爬墙虎	爬山虎
藻	海藻
海带	昆布
苔	青苔
蕈	菌
银耳	白木耳
灵芝	紫芝
香菇	香蕈
蘑菇	口蘑
黑木耳	木耳
五谷	庄稼
稻	稻子
旱稻	陆稻
麦	麦子
小麦	麦
大麦	春大麦
冬麦	冬小麦
春麦	春小麦
元麦	青稞
玉米	玉蜀黍
谷子	谷
黍子	黍
高粱	秫
糜子	糜
芡	鸡头
蔬菜	菜蔬
青菜	小白菜
白菜	大白菜
包心菜	卷心菜
球茎甘蓝	苤蓝
芥菜	芥
花椰菜	花菜
油菜	菜
韭菜	韭
葱	大葱
洋葱	葱头
大葱	莞
大蒜	蒜
香菜	芫荽
宝塔菜	草石蚕
巢菜	野豌豆
金针菜	黄花菜
金花菜	黄花苜蓿
叶甜菜	牛皮菜
银条菜	银根菜
香椿	香椿头
萝卜	莱菔
胡萝卜	红萝卜
芜菁	蔓菁
茭白	菰
莴苣	莴笋
芦笋	石刁柏
辣椒	辣子
番茄	西红柿
南瓜	番瓜
黄瓜	胡瓜
菜瓜	越瓜
豆	豆子
大豆	毛豆
蚕豆	胡豆
赤豆	赤小豆
红豆	相思子
豆荚	豆角儿
菜豆	芸豆
芋	芋艿
薯	芋
甘薯	番薯
马铃薯	土豆
豆薯	地瓜
菊芋	洋姜
慈姑	茨菰
藕	莲菜
大棚菜	棚菜
水果	果品
瓜果	瓜
柚	柚子
橘	橘子
柑	柑子
橙	橙子
荔枝	丹荔
石榴	榴
樱桃	樱
橄榄	青果
橄榄	洋橄榄
枣子	枣
黑枣	软枣
苹果	苹
梨	梨子
草莓	草果
菠萝蜜	凤梨
椰	椰子
杏	杏子
李	李子
猕猴桃	羊桃
五敛子	羊桃
番木瓜	木瓜
葡萄	葡
核桃	胡桃
山核桃	小胡桃
榧	香榧
桃	桃子
蟠桃	扁桃
椰枣	海枣
桂圆	龙眼
柿	柿子
香蕉	甘蕉
花红	沙果
草果	草豆蔻
肉豆蔻	肉果
银杏	白果
香橼	枸橼
榛	榛子
杜梨	棠梨
栗子	栗
甜瓜	香瓜
甜枣	蜜枣
药草	药材
川芎	当归
萝芙木	蛇根草
大蓟	蓟
龙牙草	仙鹤草
木豆	豆蓉
乌梅	酸梅
南天竹	天竹
贝母	川贝
肉苁蓉	苁蓉
苁蓉	列当
生地	生地黄
熟地	熟地黄
麦门冬	麦冬
蒺藜	茨
人参	参
酒花	啤酒花
鱼腥草	蕺
忍冬	金银花
马齿苋	长寿菜
川军	大黄
芸香	芸
高根	古柯
钩吻	野葛
茱萸	山茱萸
肉桂	桂
枸杞	枸杞子
经济作物	技术作物
落花生	花生
油菜	菜
芝麻	麻
向日葵	葵花
蓖麻	大麻子
油瓜	油渣果
油棕	油椰子
白苏	荏
油桐	桐油树
桉树	桉
大茴香	八角茴香
桂皮	桂
甘蔗	蔗
甜菜	糖萝卜
海枣	枣椰
蓼蓝	蓝
茜草	茜
红花草	紫云英
苜蓿	紫花苜蓿
稗子	稗
茶	茶树
棉花	棉
木棉	红棉
桑	桑树
麻	蕉
大麻	线麻
种麻	苴麻
苘麻	青麻
罗布麻	茶叶花
马尼拉麻	蕉麻
芨芨草	枳机草
白藤	红藤
狼尾草	草
芦苇	苇
马兰	马蔺
龙须草	蓑衣草
国产棉	国棉
上棉	优质棉
白色棉	白棉
彩棉	彩色棉
植株	株
病株	劣株
茎	本
秆	秆子
藤	藤子
树干	树身
花茎	画轴
蒜薹	蒜苗
茬	蔸
麦茬	麦秸
枝	枝子
枝桠	枝杈
蘖	蘖枝
疯枝	疯杈
树梢	杪
柳丝	柳枝
根	根子
树根	柢
叶	叶子
枫叶	红叶
花朵	朵儿
花蕾	蕾
筒状花	管状花
花瓣	瓣
花萼	萼片
花蕊	蕊
花苞	苞
花茎	画轴
芽	胚芽
侧芽	腋芽
叶芽	叶芽儿
苗	秧
母株	母本
柄	把
果实	果子
梅子	青梅
桑果	桑葚
菱角	菱
荸荠	地梨
果皮	中果皮
核	内果皮
瓤	瓤子
种子	子实
仁	种仁
松仁	松子
花生米	花生仁
莲子	莲蓬子儿
油菜子	菜子
芡实	鸡头米
草籽	草种
葵花子	葵花仁
牲畜	畜
役畜	力畜
牲口	饩
子畜	幼畜
牺牲	牲
野兽	兽
猛兽	貔貅
狼獾	貂熊
海熊	腽肭兽
熊猫	猫熊
小熊猫	小猫熊
犀	犀牛
獾	狗獾
猪獾	沙獾
箭猪	豪猪
刺猬	猬
貉	貉子
豹猫	山猫
河狸	海狸鼠
紫貂	黑貂
黄鼠狼	黄鼬
猞猁	林
穿山甲	鲮鲤
蝙蝠	蝠
狮	狮子
虎	老虎
幼虎	乳虎
豹	豹子
象	大象
猛犸	毛象
狗熊	黑熊
马熊	棕熊
白熊	北极熊
狼	狼群
狐	狐狸
赤狐	火狐
玄狐	银狐
白狐	北极狐
草狐	花面狸
猩猩	猩
猴子	猴
鹿	麈
麋	四不象
狍子	狍
马鹿	水鹿
麂	麂子
獐	獐子
骆驼	驼
马	马匹
儿马	驹
母马	骒马
骏马	高足
驽马	劣马
骢	骓
马驹子	驹子
驴	驴子
公驴	叫驴
骡子	骡
牛	牛群
公牛	牯牛
母牛	牛
奶牛	乳牛
耕牛	犁牛
小牛	犊
羚羊	扭角羚
羊	羊群
公羊	羝
羊羔	羔羊
头羊	带头羊
羚羊	羚
石羊	岩羊
猪	猪猡
毛猪	生猪
猪仔	豚
狗	犬
猎狗	猎犬
哈巴狗	巴儿狗
兔	兔子
野兔	野猫
鼠	老鼠
小家鼠	鼷鼠
褐家鼠	大家鼠
豚鼠	天竺鼠
鼹鼠	鼹
黄鼠	大眼贼
松鼠	灰鼠
鳄鱼	鳄
扬子鳄	猪婆龙
鲸鱼	鲸
海豚	海猪
江豚	江猪
人鱼	儒艮
蛇	长虫
蟒蛇	蟒
五步蛇	白花蛇
水蛇	青蛇
蛙	青蛙
蟾蜍	癞蛤蟆
蜥蜴	四脚蛇
獭	水獭
海獭	海龙
禽兽	鸟兽
禽	鸟
猛禽	鸷鸟
隼	鹘
练鹊	绶带鸟
鹌鹑	鹑
猫头鹰	夜猫子
鸵鸟	鸵
大鸨	鸨
鹭	鹭鸶
鹗	鱼鹰
鸿雁	鸿
雉	野鸡
吐绶鸡	火鸡
野鸭	绿头鸭
天鹅	鹄
乌鸦	乌
燕	燕子
几维鸟	无翼鸟
鹈鹕	淘河
极乐鸟	风鸟
喜鹊	鹊
朱顶	贮点红
八哥儿	鸲鹆
鸬鹚	鱼鹰
黄鹂	黄莺
鹦鹉	鹦哥
杜鹃	布谷
戴胜	山和尚
鹁鸪	水鸪鸪
鲲鹏	鹏
禽畜	畜禽
鹰	老鹰
雀鹰	鹞子
秃鹫	坐山雕
雕	鹫
雀	麻雀
金丝雀	黄鸟
鸽	鸽子
家鸽	鹁鸽
野鸽	原鸽
乳鸽	白鸽
仙鹤	白鹤
海鸥	海燕
鸡	家鸡
公鸡	雄鸡
母鸡	草鸡
小鸡	角雉
笋鸡	童子鸡
鸭	鸭子
鹅	菜鹅
鱼	鲜鱼
鱼苗	鱼秧
淡水鱼	河鱼
青鱼	黑鲩
草鱼	鲩
鲫	鲫鱼
鳜	鳜鱼
鲢	白鲢
鲟	鲟鱼
鲤	鲤鱼
鳙	鳙鱼
鲥	鲥鱼
鳊	鳊鱼
乌鳢	乌鱼
鳅	泥鳅
黄鳝	鳝鱼
黄鱼	黄花鱼
乌贼	墨鱼
鳓	鳓鱼
鲳	鲳鱼
柔鱼	鱿鱼
章鱼	八带鱼
比目鱼	偏口鱼
鲨鱼	鲛
鳗鲡	鳗
大鲵	娃娃鱼
大麻哈鱼	大马哈鱼
鳕	鳘
鲚	凤尾鱼
真鲷	加级鱼
鲅	蓝点鲅
海龙	杨枝鱼
鳎	鳎目鱼
鳟	鳟鱼
鲈	鲈鱼
鱼虾	水族
龟	乌龟
鳖	鼋
蟹	螃蟹
梭子蟹	蝤蛑
寄生蟹	寄居蟹
虾	虾子
对虾	明虾
蚌	河蚌
蛤蜊	文蛤
贻贝	壳菜
牡蛎	海蛎子
蚶子	蚶
螺	螺蛳
海参	刺参
鲍鱼	鳆
海蜇	蜇
昆虫	虫
蛀虫	蛀
幼虫	毛蚴
蟋蟀	蛐蛐儿
蟑螂	蜚蠊
螳螂	刀螂
花媳妇	花大姐
蚯蚓	曲蟮
蝼蛄	蛞蝼
鲎虫	水鳖子
萤	萤火虫
蝉	知了
衣鱼	纸鱼
地蚕	地老虎
蛴螬	土蚕
水蛭	蛭
松毛虫	松虎
毛虫	毛毛虫
叩头虫	磕头虫
蜈蚣	蚰蜒
星毛虫	梨狗
白蜡虫	蜡虫
星虫	沙虫
黏虫	剃枝虫
钻心虫	蛀心虫
壁虎	蝎虎
蠹	蠹虫
蝎子	蝎
蜗牛	水牛儿
绦虫	寸白虫
肝蛭	肝吸虫
蛤蚧	蛏子
蜂	蜜蜂
蜂王	母蜂
马蜂	胡蜂
蚕	家蚕
蚕蚁	蚁蚕
蚕茧	茧子
蝶	蝴蝶
蛾	蛾子
卷叶蛾	卷叶虫
蜘蛛	蛛蛛
棉红蜘蛛	红蜘蛛
蝗虫	蚂蚱
蝗蝻	跳蝻
螟虫	螟
蚜虫	蚜
棉蚜	棉蚜虫
麦蚜	麦蚜虫
蚊	蚊子
库蚊	家蚊
按蚊	疟蚊
伊蚊	黑斑蚊
孑孓	跟头虫
蚊蝇	蚊虫
蝇	苍蝇
蚁	蚂蚁
臭虫	壁虱
跳蚤	虼蚤
水蚤	鱼虫
虱	虱子
蜱	壁虱
细菌	菌
根瘤菌	固氮菌
抗体	抗原
菌种	菌苗
病菌	病原菌
病原体	病原
酵母菌	酵母
霉菌	霉
醭	白醭
身体	肢体
形体	形骸
全身	浑身
上体	上身
下体	下身
尸体	尸首
尸蜡	木乃伊
尸骨	尸骸
遇难者	丧生者
头	首
白头	皓首
额	前额
头顶	颠
秃顶	光头
脑勺子	后脑勺子
脸	脸盘儿
颊	面颊
颏	下巴
腮	腮帮子
酒窝	笑靥
脑	脑子
颅	颅脑
脑上体	松果腺
垂体	脑下垂体
大脑皮层	皮层
眼	眼睛
秋波	秋水
老视眼	老花眼
眼球	眼珠子
眼白	白眼珠
眼眶	眼圈
眦	眼角
眼里	眼底
晶状体	水晶体
虹膜	虹彩
结膜	结合膜
视网膜	网膜
瞳孔	瞳
眼角膜	泪膜
耳	耳朵
中耳	鼓室
内耳	迷路
外耳门	耳孔
耳垂	耳朵垂
外听道	外耳道
鼓膜	耳鼓
耳轮	耳郭
鼻	鼻子
酒渣鼻	酒糟鼻
鼻孔	鼻腔
口	嘴
吻	口器
唇	嘴唇
兔唇	唇裂
嘴角	口角
舌头	舌
腭	上膛
喉	喉头
咽喉	喉咙
喉结	结喉
小舌	悬雍垂
咽	咽头
扁桃腺	扁桃体
上颌	上颚
下颌	下巴
声带	音带
牙	牙齿
乳齿	奶牙
齿龈	牙龈
臼齿	大牙
智齿	智牙
门齿	门牙
犬齿	犬牙
龋齿	蛀齿
釉质	珐琅质
颈	头颈
脖颈儿	项
肩	肩膀
胸	胸臆
胸脯	脯
胸腔	腔
怀	怀抱
心口	胸口
乳房	乳
乳头	奶头
背	背脊
腰	腰眼
腹	腹部
小腹	小肚子
肚脐	脐
臀	臀部
四肢	肢
臂	胳膊
上臂	膀子
腋	胳肢窝
肘	肘子
手	两手
手掌	巴掌
掌心	手心
拳	拳头
腕	腕子
寸口	尺中
手指	手指头
大拇指	拇指
二拇指	食指
三拇指	中指
小拇指	小指
猪手	猪爪
腿	下肢
腹股沟	鼠蹊
大腿	股
膝	膝盖
小腿	胫
腿肚子	腓
腿腕子	脚腕子
胯	裆部
脚	脚丫子
小脚	金莲
扁平足	平足
赤脚	光脚板子
脚爪	爪子
脚趾	趾
脚跟	脚后跟
脚掌	脚板
脚面	跗面
脚背	跗
蹄子	蹄
角	犄角
鹿茸	茸
羚角	羚羊角
触角	触须
尾	尾巴
鳍	划水
脊鳍	背鳍
翼	翅膀
鞘翅	翅鞘
皮肤	皮
表皮	浮皮
眼皮	眼睑
肌肉	肌
横纹肌	随意肌
平滑肌	不随意肌
腱	肌腱
脂肪	脂
寒毛	汗毛
绒毛	绒
纤毛	毫
马鬃	鬣
羽毛	羽
毛毡	毡
发	头发
黑发	乌发
小辫儿	发辫
青丝	乌云
发髻	髻
鬓	鬓角
髦	刘海
华发	宣发
胎发	胎毛
眉毛	眉
娥眉	柳眉
眉心	印堂
睫毛	眼睫毛
胡子	胡须
络腮胡子	连鬓胡子
骨骼	骨头架子
骨	骨头
骨骺	骺
头骨	颅骨
颧骨	眉棱骨
肩胛骨	胛骨
椎骨	脊椎骨
颈椎	胸椎
脊	脊骨
胸骨	龙骨
肋骨	肋巴骨
髋骨	胯骨
髂骨	肠骨
骶骨	荐骨
股骨	髀
髌骨	髌
骨节	关节
椎间盘	腰椎
指甲	甲
趾甲	脚指甲
甲壳	甲
贝壳	介壳
鳞	鱼鳞
内脏	脏器
器官	官
五脏	五中
肝	肝脏
脾	脾脏
肾	肾脏
胰	胰腺
胆	胆囊
肫	胗
鳔	鱼鳔
感官	感觉器官
气管	呼吸道
食管	食道
输尿管	尿道
肛管	肛道
肛门	肛
心	心脏
肺	肺脏
胃	肚子
肠胃	胃肠
肠	肠子
生殖器	性器官
阴茎	小便
睾丸	外肾
阴部	阴户
阴道	膣
子宫颈	宫颈
胎	胎儿
衣胞	胞衣
胚盘	胎盘
娘胎	胞胎
经络	经脉
脉	脉络
血脉	血管
毛细管	毛细血管
大动脉	主动脉
动脉弓	主动脉弓
静脉	青筋
穴道	穴位
脉搏	脉息
骨髓	髓
神经原	神经细胞
传出神经	运动神经
传入神经	感觉神经
核子	细胞核
腺	腺体
淋巴腺	淋巴结
肾上腺	副肾
前列腺	摄护腺
胸膜	肋膜
横膈膜	膈
瓣膜	瓣
血液	血
潜血	隐血
血淋淋	血丝乎拉
抗毒血清	抗菌血清
淋巴	淋巴液
激素	荷尔蒙
汗	津
痰	饮
唾液	唾
奶水	乳汁
体液	津液
胃酸	胃液
月经	经血
眼泪	泪液
鼻涕	涕
耳屎	耳垢
眼屎	眵
头皮屑	头皮
屎	矢
溏便	稀
尿	小便
精液	精
精子	精虫
卵	子
蛋	卵
鸡蛋	果儿
鸭蛋	鸭子儿
蛋黄	卵黄
蛋白	卵白
五金	金属
铂	白金
锡	焊锡
铝	钢精
金银	金银箔
金	金子
足金	赤金
银	银子
铜	黄铜
紫铜	红铜
铜线	铜丝
铝型材	铝材
钢	钢铁
硅钢	矽钢
角钢	角铁
钢轨	铁轨
钢筋	钢骨
钢水	铁水
铁	黑金
生铁	铸铁
熟铁	锻铁
灰口铁	灰铁
磁铁	磁石
镀锌铁	铅铁
镀锡铁	马口铁
木料	木头
枕木	道木
软木	软硬木
石	石头
闪石	角闪石
燧石	火石
萤石	氟石
木化石	木变石
钟乳石	石钟乳
岩石	岩
磐石	盘石
礁石	礁
卵石	河卵石
矸石	矸子
石头子儿	砾
他山石	他山之石
土	土壤
土堆	土牛
土块	坷拉
黑土	黑钙土
黏土	埴
高岭土	陶土
泥	泥巴
烂泥	稀
沙	砂
沙包	沙丘
水泥	洋灰
混凝土	砼
三合土	三和土
灰浆	砂浆
石灰	白灰
熟石灰	消石灰
沥青	地沥青
石膏	生石膏
砖	砖头
碎砖	砖头
耐火砖	火砖
瓦	瓦片
小青瓦	蝴蝶瓦
瓦垄	瓦楞
板	板子
挡板	隔板
图板	画板
管	管子
陶管	缸管
煤	煤炭
无烟煤	硬煤
焦煤	主焦煤
煤砖	蜂窝煤
褐煤	褐炭
炭	木炭
草炭	草煤
泥炭	泥煤
焦炭	焦
木柴	柴火
火煤	火捻
松明	明子
煤油	火油
石油	原油
酒精	乙醇
润滑油	滑润油
凡士林	矿脂
颜料	颜色
红土	铁丹
蓝靛	靛青
油漆	漆
蚕丝	丝
生丝	绡
棉纱	纱
化学纤维	化纤
锦纶	尼龙
涤纶	的确良
皮革	皮子
毛皮	皮桶子
胶	胶乳
鳔胶	鳔
石花胶	洋菜
橡胶	皮
硫化橡胶	胶皮
粘合剂	黏合剂
玻璃	玻
毛玻璃	磨砂玻璃
有机玻璃	不碎玻璃
釉	釉料
色釉	彩釉
珍珠	真珠
佛珠	念珠
玉石	玉
宝玉	美玉
象牙	牙
金刚钻	金刚石
赛璐珞	假象牙
吡	吡啶
搪瓷	洋瓷
电木	酚醛
肥料	肥
化学肥料	化肥
肥田粉	粒肥
颗粒肥料	粒肥
基肥	底肥
厩肥	圈肥
油饼	枯饼
尿素	脲
氨水	氢氧化铵
复合肥	复合肥料
有机肥	有机肥料
建筑	建筑物
房屋	房子
住房	住宅
楼房	大楼
城楼	箭楼
鼓楼	钟楼
大厦	高楼
广厦	深宅大院
宫殿	宫
红楼	雕梁画栋
小屋	蜗居
草屋	茅屋
棚子	棚
窑	窑洞
故居	故宅
商业楼	商住楼
民居	民宅
居民楼	单元楼
危楼	危房
城堡	城建
茅草房	草房子
别墅	山庄
公馆	官邸
房间	屋子
里屋	里间
外屋	外间
卧室	卧房
厅	大厅
饭厅	餐厅
正房	上房
厢房	厢
厨房	灶间
厕所	厕所间
卫生间	盥洗室
门房	传达室
书房	书斋
教室	讲堂
藏书室	藏书楼
录音室	录音棚
地下室	地窨子
新房	洞房
闺房	闺阁
公堂	大堂
会客厅	接待厅
展室	展厅
单间儿	单间
影厅	电影厅
门	门户
旁门	侧门
宫门	阍
阎	闾
柴门	柴扉
门扇	扉
门闩	闩
门环	兽环
门槛	门坎
窗	窗子
窗台	窗沿
窗框	窗棂
门窗	窗门
门面	门脸
地基	基础
地面	地
天花板	藻井
梁	檩
正梁	脊檩
柱	柱子
桩子	桩
墙壁	墙
城墙	城垣
箭垛子	雉堞
照壁	照墙
夹层墙	夹墙
山墙	房山
防火墙	风火墙
围墙	墙围子
隔断	隔扇
残墙断壁	断壁
长城	万里长城
篱笆	篱
栅栏	栅
屋檐	房檐
檐	檐子
水溜	檐沟
排水沟	沟
阳沟	明沟
阴沟	暗沟
阳台	平台
院子	院落
走廊	廊
台阶	踏步
石级	石阶
楼梯	梯
绳梯	软梯
栏杆	阑干
路	道
马路	街道
人行道	便道
胡同	弄堂
小街	小巷
桥	桥梁
悬索桥	吊桥
开合桥	活动桥
旱桥	天桥
过街桥	过街天桥
田地	土地
良田	肥田
休耕地	休闲地
旱地	旱田
水地	水田
承包田	承包地
田间	田里
熟荒	废耕地
田埂	埂子
园圃	园
温室	暖房
苗床	温床
圈	栏
猪圈	猪舍
马厩	马棚
笼	柙
窠	窝
蜂巢	蜂窝
鸟窝	鸟巢
陷阱	陷坑
水库	蓄水池
堤坝	水坝
圩子	圩垸
水闸	闸
沟渠	沟
沟沟壑壑	千山万壑
井	水井
机井	管井
矿井	竖井
坑道	巷道
工作面	掌子
发电站	发电厂
火电站	热电厂
仓库	仓
粮仓	谷仓
营房	营
堡垒	壁垒
掩体	掩护
鹿砦	鹿角
壕沟	战壕
园林	公园
御花园	御苑
陵园	烈士陵园
花坛	花池子
草坪	草地
塔	宝塔
象牙之塔	象牙塔
亭	亭子
阁	楼阁
舞台	戏台
讲台	讲坛
站台	月台
坟墓	坟茔
陵寝	山陵
坟头	坟山
墓道	神道
祖坟	祖茔
墓穴	穴
碑	碣
墓碑	墓表
皇宫	王宫
祠堂	宗祠
太庙	宗庙
佛殿	殿
庙宇	庙
孔庙	圣庙
寺	寺院
庵	尼姑庵
观	道观
本寺	该寺
教堂	礼拜堂
机器	机
农机	农械
工作母机	母机
蒸气机	汽机
内燃机	摩托
发动机	动力机
柴油机	狄塞耳机
发电机	电机
电动机	马达
汽轮机	汽机
涡轮机	轮机
燃气轮机	气轮机
起重机	吊车
升降机	电梯
天车	行车
钻探机	钻机
凿岩机	风钻
水压机	油压机
织布机	机子
卷扬机	绞车
掘土机	电铲
联合收割机	联合机
拖拉机	铁牛
铲土机	铲运机
鼓风机	吹风机
压路机	轧机
计算机	电脑
输送机	输机
老虎机	赌博机
电子游戏机	游戏机
彩电	彩色电视
柜员机	柜机
内存储器	内存
空调机	空调
烤箱	烘箱
家用电器	家电
放映机	放像机
工具	器
泵	唧筒
水泵	抽水机
气泵	风泵
气筒	打气筒
机床	床子
车床	旋床
冲床	冲压机
刀具	刃具
机件	器件
激光器	莱塞
化油器	汽化器
绞盘	辘轳
滑轮	滑车
飞轮	飞
齿轮	牙轮
滚珠轴承	球轴承
滚珠	钢珠
主轴	主光轴
传动带	皮带
锁链	锁
弹簧	绷簧
发条	弦
合页	合叶
阀	阀门
活塞	鞲鞴
轴瓦	轴衬
销子	销钉
离合器	靠背轮
排挡	挡
履带	链轨
轮轴	轴心
空气锤	气锤
蒸汽锤	汽锤
劈	楔子
筘	杼
钉子	钉
螺钉	螺丝
螺母	螺丝母
螺纹	螺丝扣
地脚螺丝	地脚螺栓
锭子	锭
纱锭	纺锭
制动器	闸
梭	梭子
钥匙	匙
撞锁	碰锁
拉链	拉锁
铁锁链	锒铛
零备件	附配件
电子器件	元器件
转子	旋子
步话机	步谈机
电话机	机子
电唱机	唱机
留声机	话匣子
收音机	无线电
电视机	电视
幻灯机	幻灯
受话器	耳机
发话器	话筒
微音器	送话器
扬声器	喇叭
拾音器	电唱头
电子管	真空管
继电器	替续器
容电器	电容器
两极管	二极管
原线圈	初级线圈
副线圈	次级线圈
呼机	寻呼机
手机	大哥大
电视电话	可视电话
电线	电缆
橡皮线	皮线
电料	电器
电池	干电池
蓄电池	电瓶
开关	电门
插头	插销
电闸	闸
光电池	太阳电池
农具	耕具
镰刀	镰
锄	锄头
耙	耙子
犁	犁头
铧	犁铧
耧	耩子
耢	耱
筢	筢子
水车	翻车
戽斗	戽
风车	扇车
碌碡	磙子
渔具	鱼具
鱼网	罟
鱼漂	浮子
磨子	磨盘
碾子	碾
碓	石碓
蚕箔	箔
蚕簇	山
锛	锛子
螺丝攻	丝锥
叉	叉子
筛	筛子
漏斗	漏子
扳子	扳手
钎子	钎
砂纸	砂布
千斤顶	千斤
磨刀石	砺石
砂轮	砣子
刀	刀子
铡刀	铡
錾刀	錾
剃刀	剃头刀
剪	剪刀
斧	斧头
刃	口
锤	锤子
镐	镐头
洋镐	鹤嘴镐
凿	凿子
冰镩	镩子
锹	铁锹
铲	铲子
刨	刨子
锯	锯子
锉	锉刀
板锉	扁锉
钳	钳子
镊	镊子
夹	夹子
老虎钳	虎钳
火钳	火剪
锥	锥子
改锥	赶锥
棒	棒子
通条	火棒
木棒	木棍
铁棍	铁棒
擀杖	擀面杖
杠	杠子
扁担	担子
墩子	墩
砧板	案板
砧	砧子
模具	胎具
模型	模子
坯	土坯
坯子	砖坯
模板	沙盘
铜模	字模
楦子	楦
夹具	卡具
榫头	榫子
雕版	梓
纸版	纸型
版心	页心
套版	套色版
活版	活字版
仪表	仪器
电流计	安培计
电表	电度表
电压计	伏特计
温度计	温度表
体温计	体温表
指南针	南针
浑天仪	浑仪
水准器	水平
圭表	圭
测试仪	探测仪
流量计	流量表
尺	直尺
丁字尺	丁字规
表尺	标尺
三角尺	三角板
曲尺	矩尺
计算尺	算尺
游标卡尺	卡尺
弓	步弓
秤	衡器
磅秤	台秤
秤锤	秤砣
秤毫	毫
斗	斛
炉子	火炉
灶	炉灶
高炉	鼓风炉
马丁炉	平炉
火油炉	煤油炉
听诊器	听筒
注射器	针
金针	针
脱脂棉	药棉
橡皮膏	胶布
拐杖	拐棍
月经带	卫生带
车	车辆
机车	火车头
火车	列车
轿车	卧车
自行车	脚踏车
赛车	跑车
篷车	棚车
敞车	敞篷车
闷子车	闷罐车
斗车	罐
铲车	铲运车
人力车	洋车
手推车	手车
大板车	排子车
平板车	三轮儿
大车	辂
拖车	挂斗
班车	交通车
灵车	柩车
车驾	凤辇
船	船舶
小船	扁舟
舶	舸
邮轮	邮船
游船	游艇
汽艇	快艇
渡船	摆渡
渡轮	轮渡
救生艇	救难船
舢板	三板
拖轮	拖船
龙舟	龙船
皮划艇	皮艇
筏子	筏
木筏	槎
排筏	排
飞机	铁鸟
飞艇	飞船
轿子	轿
花轿	彩轿
雪橇	爬犁
舵	艄
桨	桡
帆	篷
桅杆	桅
舱	厢
车把	把
方向盘	舵轮
车轮	轮子
轮胎	轮带
外胎	外带
内胎	里带
鞍	鞍子
辔	辔头
笼头	羁
马鞍	马鞍子
马掌	马蹄铁
鞭子	鞭
武器	火器
原子武器	核子武器
枪	枪支
步枪	大枪
盒子枪	驳壳枪
机关枪	机枪
炮	火炮
无坐力炮	无座力炮
火箭炮	喀秋莎
瞎炮	哑炮
刺刀	枪刺
弹药	弹
枪弹	子弹
燃烧弹	烧夷弹
榴霰弹	子母弹
氢弹	热核武器
霰弹	群子弹
飞弹	流弹
弹头	弹丸
弹壳	药筒
手榴弹	手雷
炸药	火药
梯恩梯	黄色炸药
弓	弩弓
箭	矢
响箭	鸣镝
暗箭	暗器
箭头	箭镞
箭靶子	靶子
矛	长矛
枪	长枪
盾	盾牌
印尼盾	印度尼西亚盾
剑	宝剑
短剑	匕首
上方宝剑	尚方宝剑
军舰	兵舰
战列舰	战斗舰
护卫舰	护航舰
潜水艇	潜艇
炮艇	护卫艇
战斗机	歼击机
主机	长机
坦克	坦克车
装甲车	铁甲车
火箭	运载火箭
纸牌	叶子
骨牌	牙牌
扑克	扑克牌
麻将	麻雀
色子	骰子
旱烟袋	烟袋
水烟袋	水烟筒
烟斗	烟嘴儿
刑具	大刑
铡刀	铡
镣	脚镣
铐	手铐
镣铐	桎梏
灯	灯火
日光灯	荧光灯
台灯	桌灯
汽灯	保险灯
本生灯	煤气灯
马灯	桅灯
风灯	风雨灯
油灯	灯盏
灯笼	纱灯
手电筒	电筒
电灯泡	灯泡
灯罩	灯伞
灯心	炷
灯台	檠
镜子	镜
凹面镜	凹镜
凸面镜	凸镜
凹透镜	发散透镜
凸透镜	放大镜
三棱镜	棱镜
眼镜	镜子
透镜	镜片
墨镜	茶镜
花镜	老花镜
望远镜	千里眼
接物镜	物镜
接目镜	目镜
刷	刷子
帚	扫帚
鸡毛掸子	掸子
拖把	墩布
毛巾	手巾
手绢	手巾
头帕	头巾
肥皂	胰子
梳子	梳
针	金针
针鼻儿	针眼
顶针	针箍
线	缕
丝线	绒线
毛线	绒线
线桄子	线轴儿
针线	针头线脑
锅	釜
火锅	一品锅
平底锅	铛
高压锅	压力锅
壶	铫
便壶	夜壶
蒸笼	笼屉
勺子	勺
舀子	水瓢
匙子	匙
筷子	筷
盆	盆子
钵	钵头
钵盂	钵
缸盆	瓦盆
澡盆	浴盆
痰盂	痰桶
马桶	恭桶
瓶	瓶子
冰瓶	保温瓶
暖水瓶	保温瓶
花瓶	花插
吊瓶	输液瓶
盘	盘子
碟	碟子
杯	杯子
酒杯	酒盅
坛子	坛
酒坛	埕
罐子	罐
储存罐	储罐
缸子	缸
箱	箱子
书箱	笈
信箱	邮箱
竹箱	簏
提箱	手提箱
果皮筒	果皮箱
保健箱	急救箱
举报箱	信报箱
盒子	匣子
烟盒	香烟盒
八音盒	八音匣子
暗盒	黑匣子
篮	篮子
篓	篓子
背篓	驮篓
笼	笼子
箩筐	箩
淘箩	筲箕
笆斗	栲栳
簸箕	畚箕
粪箕子	粪筐
提包	手提包
麻包	麻袋
沙包	沙袋
钱包	皮夹子
袋	袋子
网袋	网兜
纸口袋	纸袋
背搭子	褡裢
套	套子
鞘	韬
书套	书函
被套	被袋
滚轮	虎伏
浪木	浪桥
拉簧	扩胸器
杠子	杠
球	球类
乒乓球	台球
康乐球	克郎球
球拍	拍子
弹子	台球
棋	棋子
棋盘	围盘
乐器	法器
打击乐器	响器
弦乐器	丝弦
古琴	七弦琴
三弦	弦子
二胡	南胡
扬琴	洋琴
六弦琴	吉他
阮咸	阮
箫	洞箫
排箫	参差
笙	参差
笛	笛子
号	喇叭
号角	角
小锣	铴锣
鼓槌	桴
拍板	鼓板
老弦	里弦
子弦	外弦
幕	幕布
布景	景
照相机	相机
摄影机	录相机
胶片	软片
影片	片子
拷贝	正片
底片	底版
正色片	分色片
文具	文房四宝
印泥	印色
印台	打印台
信封	封皮
图钉	摁钉儿
糨糊	糨子
钢板	誊写钢版
笔	笔杆
毛笔	毫
钢笔	自来水笔
圆珠笔	原子笔
笔套	笔帽
笔铅	笔心
墨	松烟墨
墨汁	墨水
纸	纸张
报纸	白报纸
宣纸	宣
玉版纸	玉版宣
稿纸	原稿纸
信纸	信笺
吸墨纸	吸水纸
手纸	草纸
砚	砚台
簿册	簿子
表册	表
笔记本	笔记簿
帐簿	帐本
名册	人名册
户口簿	户口册
折子	折
食谱	菜谱
聘书	聘约
卡片	卡
承诺卡	保证卡
名帖	名片
帖	柬
请帖	请柬
黑帖	无名帖
单据	票据
借条	借据
收条	收据
存执	存根
发票	发单
保单	保单
结	保证书
提单	提货单
门票	入场券
站台票	月台票
往返票	来回票
免票	赠券
证书	证明
路条	路签
文凭	毕业证书
执照	照
行车执照	驾照
合格证	合格证书
凭证	凭据
虎符	兵符
标志	标记
牌子	牌
路牌	指路牌
筹码	筹
签子	签
封条	封皮
幛子	幛
匾	匾额
横幅	横披
界桩	桩子
令箭	令旗
旗帜	旗子
军旗	麾
招子	幌子
旗杆	杠
图章	印章
徽章	证章
帽徽	帽章
袖章	袖标
蜡烛	烛
蜡台	烛台
香烛	香火
火柴	洋火
火把	火炬
纽扣	纽
子母扣儿	摁扣儿
襻儿	纽襻
结	结子
活结	活扣
死结	死扣
绳	索
缰绳	絷
钢索	钢缆
链	链子
带	带子
彩带	彩练
绶带	绂
腰带	褡包
腿带	绑腿
吊带	吊袜带
桌子	台子
方桌	八仙桌
圆桌	圆台
书桌	书案
梳妆台	镜台
条案	条桌
抽屉	抽斗
椅子	椅
圈椅	安乐椅
凳子	凳
长凳	条凳
床	榻
行军床	帆布床
木床	板床
病床	病榻
橱	柜
碗橱	碗柜
衣橱	衣柜
床边橱	床边柜
保险柜	保险箱
栏柜	拦柜
屏风	屏
卧具	寝具
被褥	铺盖
被子	被卧
棉絮	棉花胎
褥子	垫被
草垫子	草荐
毯子	毯
枕头	枕
床单	褥单
帐子	蚊帐
席子	席
篾席	竹席
草席	荐
帘子	帘
幔	幔帐
窗帘	窗幔
帐幕	帐篷
垫子	垫
罩子	罩
奶罩	胸罩
面罩	面纱
钟	时钟
座钟	台钟
表	手表
马表	跑表
怀表	挂表
表针	指针
表盘	表面
漏刻	漏壶
化妆品	脂粉
生发油	头油
唇膏	口红
扑粉	香粉
香水	花露水
饰物	装饰品
流苏	穗子
发夹	发卡
首饰	头面
戒指	戒
耳环	耳坠子
项链	项练
镯子	手镯
玉簪	发簪
绣品	刺绣
伞	阳伞
盖	华盖
阳伞	旱伞
扇子	扇
葵扇	芭蕉扇
团扇	纨扇
电扇	风扇
暖壶	汤壶
烘篮	烘笼
玩具	玩意儿
弹子	玻璃球
风筝	纸鸢
玩偶	托偶
拨浪鼓	波浪鼓
铃	铃铛
梆子	梆
哨子	哨
醒木	惊堂木
烟火	焰火
爆竹	炮仗
双响	二踢脚
鞭炮	鞭
棺材	棺木
灵柩	灵榇
寿材	寿木
骨灰盒	骨灰箱
冥器	殉葬品
灵牌	灵位
俑	偶人
银锭	锡箔
衣料	料子
毛料	料子
零头	布头
布	布匹
粗布	毛布
斜纹布	斜纹
羽缎	羽毛缎
卡其	咔叽
花布	印花布
夏布	麻布
灯芯绒	条绒
丝绸	绸缎
纺绸	小纺
纨	缣
练	缟
柞丝绸	茧绸
香云纱	莨绸
春绸	线春
彩绸	彩
毛葛	葛
呢绒	呢子
直贡呢	礼服呢
驼绒	骆驼绒
针织	针织物
衣服	衣物
大衣	大氅
披风	斗篷
披肩	帔
长衫	大褂
罩衫	罩袍
内衣	小衣裳
中装	中服
西装	西服
盛服	盛装
礼服	大礼服
朝服	蟒袍
便装	便服
外衣	外套
夏装	夏衣
冬装	冬衣
皮衣	裘
童装	小衣裳
兜肚	兜兜
睡衣	睡袍
军服	军装
法衣	袈裟
戏装	戏衣
孝服	重孝
鹑衣	百衲衣
上装	上衣
背心	马甲
马褂	单褂
衬衣	衬衫
汗衫	汗褂
绒衣	卫生衣
裤子	裤
衬裤	裤衩
绒裤	卫生裤
裙子	裙
连衣裙	布拉吉
领子	领
裤腰	腰
衣袋	口袋
袖子	衣袖
衣襟	衽
大襟	裾
后襟	后身
前襟	前身
帽	帽子
斗笠	箬帽
小帽	瓜皮帽
纱帽	乌纱帽
皇冠	王冠
鞋	鞋子
拖鞋	趿拉儿
木屐	趿拉板儿
皮鞋	革履
绣花鞋	绣鞋
雨鞋	钉鞋
跑鞋	钉鞋
靴	靴子
头巾	网巾
围巾	围脖儿
袜子	袜
手套	拳套
粮食	食粮
干粮	糇粮
粗粮	糙粮
米	大米
籼米	机米
碎米	粞
江米	糯米
糙米	粝
秫米	高粱米
米粒	糁
米粉	米面
面粉	白面
玉米面	棒子面
麸子	麸皮
饲料	草料
粮草	粮秣
鱼饵	钓饵
鱼虫	金鱼虫
食物	食品
饭食	饭菜
熟食	烟火食
消夜	飧
主食	主食品
副食	副食品
零食	零嘴
肉品	肉食品
饭	米饭
盖饭	盖浇饭
份儿饭	客饭
粥	稀饭
羹	肉汤
锅巴	锅贴
面条	面
汤面	面汤
抻面	拉面
削面	刀削面
卷子	卷
馒头	包子
饼子	饽饽
杂粮	粗粮
窝头	窝窝头
油茶	油茶面儿
菜肴	菜
酒食	酒饭
美食	美味
山珍海味	水陆
糟糠	粗茶淡饭
冷盘	拼盘
菜码儿	浇头
荤菜	荤腥
全家福	一品锅
鱼鲜	海鲜
肉排	排骨
肉末	肉松
肉丸	狮子头
脯	腊肉
烤肉	炙
猪蹄	蹄子
粉蒸肉	米粉肉
白肉	肥肉
杂碎	下水
肥肠	圈子
虾米	海米
干贝	江珧柱
鱼翅	翅
鲞	鲞鱼
咸鱼	鲍鱼
松花	松花蛋
肉片	脔
生肉	鲜肉
素菜	素
千张	豆腐皮
豆腐干	香干
豆腐乳	酱豆腐
豆腐皮	豆腐衣
豆芽儿	豆芽菜
粉条	粉
粉丝	粉
调味品	作料
八角	大料
味精	味素
淀粉	小粉
胡椒	胡椒面
姜	生姜
花椒	椒
动物淀粉	糖原
油	食油
素油	清油
猪油	大油
菜油	菜子油
茶油	清油
花生油	生油
芝麻油	麻油
板油	脂油
盐	食盐
岩盐	矿盐
酱	醢
芝麻酱	麻酱
果子酱	果酱
醋	醯
糖	食糖
点心	点
甜食	甜品
糕点	饽饽
糕饼	饵
饼	饼饵
烙饼	饼子
烧饼	大饼
油条	油炸鬼
饺子	饺
汤圆	汤团
团子	团
粽子	粽
馄饨	抄手
江米酒	酒酿
糖果	糖
饴糖	饴
糖稀	饧
糖葫芦	冰糖葫芦
蜜饯	果脯
果料儿	果仁儿
馅料儿	心子
酵子	鲜酵母
发粉	起子
酒曲	酒母
面肥	发面
饮料	饮
豆浆	豆乳
可可	可可茶
咖啡	咖啡茶
冰棍儿	冰糕
冰激凌	冰淇淋
冰糕	雪糕
茶	茶叶
砖茶	茶砖
花茶	香片
茶晶	茶卤
酒	酿
美酒	醇酒
黄酒	绍兴酒
白酒	烧酒
甜酒	醴
清酒	水酒
乳酪	酪
酥油	油
药品	药物
中药	国药
丸	丸药
散	药粉
膏	膏药
汤药	汤
药引子	引子
饮子	饮
针剂	针
试剂	试药
冲剂	浸剂
麻醉剂	蒙药
栓剂	坐药
制剂	药剂
酊剂	酊
酏剂	酏
醑剂	醑
灵丹	妙药
青霉素	地霉素
磺胺	氨苯磺胺
牛痘苗	痘苗
结核菌素	结素
安眠药	催眠药
红汞	汞溴红
龙胆紫	甲紫
麝香	麝
奎宁	金鸡纳霜
阿胶	驴皮胶
蜂王浆	王浆
蜂蜜	蜜
樟脑丸	卫生丸
滴滴涕	敌百虫
避孕片	避孕药
咖啡因	茶精
造影剂	显影液
维生素	维他命
维生素	烟酸
补品	滋补品
保鲜剂	防腐剂
去污剂	清洁剂
毒品	毒物
毒酒	鸩毒
海洛因	白面儿
鼠药	耗子药
鸦片	阿片
砒霜	白砒
烟	烟草
香烟	纸烟
雪茄	卷烟
烟斗丝	斗烟丝
烟丝	烟
烟头	烟蒂
阳历	太阳历
阴历	太阴历
伊斯兰教历	回历
公元	纪元
时代	年代
古代	古
近代	近现代
现代	当代
盛世	治世
乱世	浊世
新篇章	新纪元
朝代	王朝
历朝历代	历代
年代	年岁
时期	时代
年月	日月
时间	时刻
日期	日子
一向	阵子
时候	时节
时机	天时
关头	关键
平时	平常
暇时	闲暇
期限	限期
期间	间
始终	前后
初期	前期
年初	年头
月初	朔望
中期	中叶
正月十五	月中
末期	后期
年终	年底
月终	月底
现在	现时
目前	眼前
过去	从前
自古	古来
从小	自小
至今	迄今
以前	先前
事先	之前
前夕	前夜
近来	近日
将来	未来
即日	不日
改日	改天
以后	之后
一会儿	不一会儿
身后	百年之后
隔日	间日
一生	一世
今生	今世
半生	半世
前半辈子	前半生
后半辈子	后半生
年龄	年纪
不惑	不惑之年
半百	知天命之年
高龄	遐龄
牙口	口
低龄	幼龄
童年	幼年
少年	妙龄
青年	青春
壮年	中年
晚年	老年
年	年份
十年	旬
百年	世纪
今年	当年
明年	来年
去年	去岁
每年	年年
四季	四时
春	春季
初春	开春
暮春	季春
夏	夏季
初夏	夏初
炎夏	炎暑
秋	秋季
深秋	晚秋
冬	冬季
严冬	隆冬
季节	季
黄梅	黄梅季
伏天	三伏
中伏	二伏
末伏	三伏
数九	九
月	月份
正月	新月
二月	仲春
三月	季春
四月	四月份
五月	仲夏
八月	仲秋
九月	暮秋
十月	小阳春
十一月	仲冬
十二月	腊月
小月	小建
星期	周
星期一	周一
星期二	周二
星期三	周三
星期四	周四
星期五	周五
星期六	周六
星期日	星期天
日	天
当日	当天
今日	今天
明日	明天
昨日	昨天
前日	前天
初一	朔日
月半	望日
月底	晦
每日	每天
双日	单日
半日	全天
节气	节
夏至	长至
冬至	长至
节日	节
佳节	节令
妇女节	三八节
劳动节	五一节
八一建军节	八一
除夕	年夜
年初一	大年初一
春节	年节
元宵节	上元节
端午节	端午
中秋节	八月节
重阳节	重阳
假日	假期
生日	诞辰
忌日	忌辰
婚期	佳期
吉日	好日子
黎明	凌晨
早晨	早上
清晨	一清早
朝朝暮暮	花朝月夕
上午	午前
中午	正午
下午	午后
白天	白昼
傍晚	黄昏
晚上	夜晚
当晚	当夜
夜间	夜里
半夜	夜半
深夜	漏夜
前半夜	上半夜
后半夜	下半夜
昼夜	日夜
早晚	晨昏
小时	钟点
时	点钟
学时	课时
时辰	时
这时	这时候
那时	那时候
几时	何时
方向	方位
同方向	一顺儿
位置	部位
座位	位子
上座	上位
下位	末座
铺位	床位
东南西北	四方
东	东方
南	南方
西	西方
北	北方
上	上面
以上	之上
下	下面
以下	以次
左	左面
右	右面
前	前面
后	后面
中	中间
内	中
深处	奥
国内	海内
外	外面
室外	露天
野外	郊外
国外	海外
内外	里外
旁边	边缘
耳畔	耳际
附近	就近
手头	手边
周围	四周
对面	对门
天	天空
高空	太空
晴空	青天
空中	空间
天际	天边
地	大地
地方	地域
市区	城区
故地	旧地
空地	隙地
立锥之地	弹丸之地
源	源头
北国	北疆
地点	地址
汇合处	交界处
农技站	农技推广站
灌溉站	排灌站
推广站	宣传站
飞机场	机场
空白点	空白处
宅基地	居所
到处	各处
遍地	匝地
山区	山国
水乡	泽国
上游	上流
中游	中流
下游	下流
远方	远处
边远	边地
僻壤	荒漠
内地	腹地
前方	前线
阵地	防区
后方	大后方
驻地	营地
战场	疆场
领土	疆土
孤岛	半壁江山
属地	采地
失地	敌占区
边疆	边界
界线	界
本地	本土
外地	外边
家乡	故乡
胜地	佳境
乐园	乐土
树荫	绿荫
荒地	荒
坟地	墓地
要地	要冲
险地	险
关口	关
卡子	卡
廉洁关	廉政关
验收关	检验关
设卡	立卡
渡口	渡头
路口	街口
十字路口	十字街头
岔口	三岔路口
通道口	入口
缺口	破口
决口	决
洞	孔
山洞	岩洞
地洞	地道
卯眼	凿
缝	罅
空隙	空儿
坑	坑穴
点	心
线	线条
垂线	垂直线
圆心角	中心角
多面角	立体角
倾角	倾斜角
磁倾角	倾角
面	平面
剖面	切面
横剖面	横切面
纵剖面	纵切面
水平面	水准
立方体	正方体
球体	球
角锥体	棱锥
角柱体	棱柱体
几何体	立体
拐角	拐弯
角落	犄角
城市	市
码头	埠
大都市	大都会
我市	本市
危城	旧城
集镇	镇
乡村	农村
村庄	村
荒村	三家村
寨子	寨
车站	站
港口	口岸
道路	路途
陆路	旱路
水路	水道
大路	大道
小路	便道
山路	山道
弯路	弯道
岔路	岔道
远路	远道
近路	近道
要道	孔道
隘路	畏途
中途	半途
高架道路	高架路
盘山路	盘山道
主干路	主干道
路线	路
轨道	轨迹
航路	航线
场所	处所
现场	当场
住所	寓所
哨所	岗哨
试场	考场
市场	商场
集市	市集
刑场	法场
屠场	屠宰场
会馆	会所
容身之地	宿处
英雄无用武之地	无用武之地
妓院	烟花巷
巢穴	老巢
匪巢	匪窟
赌窟	赌场
这里	这边
那里	那边
哪里	何处
事情	事
事项	须知
两回事	两码事
事实	实事
国事	国务
政事	政务
外事	外务
要事	大事
公事	公务
急事	急
危险	奇险
难事	难题
时事	新闻
趣事	佳话
好事	佳话
乐事	快事
喜事	好事
婚事	亲事
丧事	白事
红白喜事	红白事
佛事	法事
憾事	恨事
世事	尘世
逸事	轶事
奇事	怪事
遗事	事迹
风流韵事	韵事
琐事	琐屑
家事	家务
秘事	秘密
机密	事机
亏心事	缺德事
坏事	勾当
丑	丑事
鳞爪	片断
蠢事	傻事
非公务	私事
事事	万事
新鲜事	新人新事
风险	高风险
事件	事变
惨案	血案
事故	事
麻烦	枝节
意外	万一
变故	变
波折	曲折
沧海桑田	沧桑
动乱	变乱
十年动乱	十年浩劫
风潮	浪潮
狂澜	狂飙
涡流	水涡
群众运动	人民战争
工人运动	工运
狂潮	热潮
事例	例
比方	譬喻
先例	前例
惯例	向例
案件	案子
血案	命案
疑案	悬案
冤案	冤狱
投诉案	诉讼案
本案	该案
大要案	大案要案
疑问	问号
嫌疑	嫌
过程	进程
始末	本末
内中	其中
开端	肇端
破天荒	开天辟地
新春伊始	新年伊始
末尾	末了
结局	终局
往事	旧事
经历	阅历
历史	史
艳史	浪漫史
病历	病案
古代史	古史
科学史	科技史
建筑史	建设史
政策史	谋略史
战史	军史
医史	医学史
前途	前景
出息	争气
遭遇	遭际
风浪	风霜
宦途	仕途
冷遇	冷眼
惨境	凄风苦雨
冷暖	炎凉
顺境	佳境
逆境	下坡路
命运	气运
红运	幸运
苦命	薄命
背运	厄运
时运	时气
同呼吸共命运	共命运
福气	福分
灾祸	灾难
灾害	灾患
祸事	祸乱
浩劫	灭顶之灾
横祸	横事
祸根	祸胎
兵乱	兵燹
匪祸	匪患
外祸	外患
遗祸	后患
天灾	灾荒
涝灾	涝害
水灾	水患
火灾	火警
旱灾	大旱
饥荒	饥
海难	海事
地震	地动
虫灾	虫害
风灾	风害
祸福	吉凶
苦痛	痛苦
疾苦	困苦
磨难	折磨
难题	难点
挫折	失败
冤屈	冤枉
沉冤	不白之冤
恩惠	恩典
大德	大恩大德
甜头	小恩小惠
活命之恩	救命之恩
冤仇	冤
切骨之仇	深仇大恨
世仇	旧恶
恩怨	恩仇
分歧	龃龉
嫌隙	隙
荣誉	荣耀
耻辱	羞辱
污点	秽迹
荣辱	盛衰荣辱
成就	造就
收获	果实
建树	卓有建树
新绩	纪录
功劳	功
一等功	头等功
勋劳	勋绩
业绩	功绩
殊勋	奇勋
战功	武功
伟绩	伟业
功在千秋	功在当代
过失	过错
功过	功罪
是非	好坏
差错	过错
一差二错	阴差阳错
漏洞	漏子
经验	体验
教训	鉴
借鉴	龟鉴
印象	记忆
生命	性命
生死	存亡
寿命	寿
长命	长寿
残生	余生
生活	日子
衣食	家常
性生活	性行为
戎马一生	戎马生涯
身心	心身
生计	活计
饮食	茶饭
西餐	大菜
便饭	便酌
酒饭	酌
早饭	早餐
中饭	午饭
晚饭	夜饭
包饭	包伙
消息	新闻
风声	风
佳音	福音
传闻	传说
死讯	死信
谣言	谣
桃色新闻	绯闻
音信	音问
形势	情势
现势	现局
危局	危亡
全局	大局
时势	时局
平局	和局
趋势	趋向
长势	生势
颓势	下坡路
潮流	浪头
情况	情形
真情	实情
内情	内幕
来头	来路
详情	端详
概况	概貌
境况	光景
老境	晚景
家境	家道
病情	病况
市面	市场
世面	场面
实景	实处
境地	境域
困境	困厄
惨境	火坑
绝境	绝地
险境	危境
境界	境域
意境	意象
佳境	梦境
梦乡	梦境
环境	条件
气氛	空气
现象	象
陨石雨	流星雨
迹象	征象
苗头	苗子
症状	症候
预兆	先兆
吉兆	彩头
凶兆	不祥之兆
下落	着落
踪迹	踪影
行踪	行止
气候	天候
月令	节令
季风气候	小气候
收成	收获
年成	年光
秋景	大秋
丰年	大年
平年	常年
荒年	歉年
效用	功用
用处	用途
实效	证验
特效	神效
副作用	负效应
反应	影响
反作用	反动
名声	名气
名望	美誉
盛名	大名
众望	人望
骂名	秽闻
虚名	浮名
声威	威名
情面	人情
面子	体面
势力	势
权势	威武
恶势力	魔爪
威风	威严
气势	势
锐气	锐
凶焰	凶气
笔力	骨气
事物	物
对象	目标
原因	因
起因	缘起
情由	事由
病因	病源
祸根	祸端
结果	后果
报应	报
恶果	苦果
根源	本源
源头	源流
来源	源
水头	水源
证据	左证
明证	铁证
根据	依据
论证	论据
指针	南针
借口	由头
理由	理
把柄	辫子
笑柄	笑谈
话柄	口实
典故	典
出典	出处
目的	鹄的
宗旨	大旨
规律	法则
定律	定理
经济规律	经济法则
自然规律	自然法则
逻辑	论理
道理	理路
大道理	大义
真理	真谛
正理	公理
歪理	邪说
正义	义
天理	天道
教义	佛法
玄机	玄
情理	物理
世情	人情
死理	一面儿理
意义	义
定义	界说
蕴意	意蕴
内蕴	内涵
头绪	头脑
条理	条
思路	笔录
笔法	笔路
立场	立脚点
角度	观点
就业观	择业观
方法	法子
常轨	常规
兵法	韬略
障眼法	遮眼法
反证法	归谬法
花点子	花花点子
茶道	茶艺
灸	腌
集约经营	集约
诀窍	诀要
步骤	步调
关系	瓜葛
群众关系	人缘儿
友谊	情谊
老交情	旧交
深情	鱼水情
深交	至交
私交	私情
邦交	国交
缘分	因缘
形状	样子
怪相	奇形怪状
地形	地势
体形	身段
条形	线形
多边形	多角形
三角形	三角
菱形	口形
正多边形	正多角形
几何图形	图形
棱锥台	棱台
圆锥台	圆台
圆圈	圈子
状态	态
式样	样式
时样	时式
排比	排偶
惨象	惨状
密闭式	封闭式
装饰	装璜
风景	景色
春光	春色
秋景	秋色
晚景	夜景
旧景	旧貌
青山秀水	清山秀水
名胜古迹	胜迹
景象	现象
美景	良辰美景
幻境	幻影
村容村貌	村容
新气象	新景观
容貌	相貌
美貌	红颜
姿势	姿
雄姿	英姿
婀娜多姿	摇曳多姿
步伐	步履
退步	后步
方步	四方步
装束	打扮
艳妆	靓妆
仪表	仪容
神情	神色
态度	姿态
言谈	辞色
眼色	眼神
眼光	目光
脸色	面色
笑容	笑脸
喜色	喜气
愁容	愁云
怒容	怒色
凶相	煞气
惧色	惊魂
醉意	酒意
美色	女色
风度	风采
骨气	风骨
豪气	英气
骄气	傲气
书卷气	书生气
性质	习性
趋光性	慕光性
准确性	准头
可能性	可能
音质	音色
生产经营性	营业性
紧缩性	伸缩性
预见性	前瞻性
广泛性	普及性
不确定性	可变性
诱导性	诱惑性
革命性	探索性
指导性	指令性
背日性	背光性
流动性	流通性
试验性	实验性
紧迫性	迫切性
敏感性	过敏性
趋向性	趋利性
条理性	逻辑性
礼节性	象征性
鼓动性	拉动性
可持续性	延续性
可操作性	操作性
自营性	自主性
永久性	永恒性
局部性	区域性
优点	长处
各有所长	学有所长
缺点	缺欠
益处	好处
现成饭	渔人之利
微利	蝇头微利
功名利禄	名利
害处	坏处
积弊	宿弊
切身利益	既得利益
利弊	利害
特征	特点
差别	别
上下	高低
天壤之别	霄壤之别
存小异	存异
范围	范畴
势力范围	地盘
手心	掌心
省里	省内
火力网	火力圈
通篇	全文
辖区	管区
方面	上面
处处	各方
领域	天地
界	林
一方面	一边
双方	双边
多方面	多边
官场	宦海
文学界	文坛
文艺界	艺苑
诗坛	书坛
学界	知识界
借方	收方
戏曲界	梨园
贷方	付方
着力点	着力处
前端	前者
负面	阴暗面
商业界	商界
汽车界	汽车业界
各界	各行各业
工商界	工商企业界
社科界	社会科学界
环节	环
系统	系
血统	血缘
分系统	子系统
合作网	协作网
互联网	互联网络
观测网	监测网
互联网	计算机网
管网	管道网
种类	类别
物种	种
新品种	新品
此类	该类
雌雄同体	雌雄同株
雌雄异体	雌雄异株
低高型	高低型
研究型	科研型
结构	构造
班子	架子
梯队	梯级
建制	体制
次序	次第
词序	语序
席次	座次
层次	层系
排行	行
流水线	流程
头一回	首轮
下一场	接下来
本次	此次
白班	日班
行列	行
一行	一条龙
雁行	雁阵
工薪层	工薪阶层
表面	外表
门面	伪装
实质	精神
根本	基本
关键	症结
地心	地核
核心	中心
中枢	心脏
因素	要素
成分	分
水分	潮气
养分	营养
标准	基准
准则	信条
榜样	样板
好榜样	表率
师表	师范
垂范	典型
质量	品质
水平	水准
高质	质量上乘
基础	根基
界限	界线
只限	限于
下线	底线
限度	限
顶点	顶峰
极致	极了
阴极	负极
正极	阳极
分寸	尺寸
分量	斤两
力气	气力
死力	死劲儿
体力	膂力
脚力	脚劲
人力	人工
大力	鼎立
绵薄	犬马之劳
力量	力
生命力	活力
劳力	劳动力
视力	目力
财力	资力
兵力	军力
武力	暴力
法力	佛法
反冲力	坐力
附着力	黏着力
引力	吸力
地心引力	重力
万有引力	引力
拉力	张力
旁压力	侧压力
内聚力	凝聚力
笔力	骨力
蓬勃生机	勃勃生机
运力	加力
能量	能
势能	位能
热能	热量
核子能	核能
名称	名目
美名	美称
尊称	大号
爱称	昵
别称	又称
俗称	俗名
名目	名堂
名义	名
幌子	招牌
牌子	牌
曲牌	牌子
标题	题目
副标题	副题
罪名	帽子
姓名	全名
姓	姓氏
复姓	双姓
贵姓	尊姓
名字	名
大名	芳名
表字	字
小名	乳名
假名	化名
别名	别号
外号	绰号
客姓	外姓
生肖	属相
性别	性
籍贯	籍
原籍	祖籍
户籍	户口
川籍	四川籍
资格	身价
出身	身家
辈分	行辈
吾辈	吾侪
平辈	同辈
上辈	长辈
下辈	小辈
体格	腰板儿
身体	人
性格	性情
天性	个性
牛脾气	牛性
老脾气	故态
孩子气	稚气
品行	品性
人格	人品
高风亮节	德艺双馨
道德	德行
美德	贤德
妇道	三从四德
作风	气
阔气	阔
平均主义	大锅饭
利己主义	个人主义
伦常	人伦
孝道	孝
节操	节
大节	大德
贞操	贞节
胆量	胆力
魄力	气魄
血性	血气
气量	器量
海量	洪量
气概	骨气
侠骨	铁骨
智慧	智
天资	天才
心窍	心劲
才智	聪明才智
才能	才力
才华	才气
奇才	雄才
口才	辩才
文才	笔墨
本领	本事
技术	技能
神通	三头六臂
特长	专长
武艺	本领
舞技	舞艺
球技	球艺
高技术	高新技术
战技术	战术
能力	力量
记忆力	记性
眼力	眼光
功夫	功力
修养	涵养
思想	思
思想意识	观念
精神	魂
心思	情思
脑子	脑
脑海	脑际
意匠	匠心
思路	思绪
上进心	进取心
警惕性	戒心
信心	信念
忌妒心	妒忌心
感想	感
内心	心里
居心	用心
心事	心曲
恻隐之心	慈心
良心	人心
丹心	赤心
私心	私念
邪心	贼心
外心	异心
黑心	恶心
感觉	知觉
味道	滋味
同感	共鸣
感情	情愫
常情	人情
心意	情意
本心	本意
好心	善心
厚意	雅意
谢意	谢忱
歉意	歉
假意	虚情假意
心情	情绪
豪情	激情
民情	群情
世情	人情
亢奋	激奋
爱情	情爱
春情	风情
苦心	苦口婆心
忧心	忧虑
心病	隐痛
怒火	怒气
众怒	公愤
不平	夹板气
怨气	怨
幽怨	幽愤
宿怨	积怨
欲望	欲念
情欲	人事
需要	需求
指望	希望
愿望	希望
志愿	志
夙愿	素愿
初愿	初衷
意图	图
意旨	旨意
计划	规划
大计	鸿图
小九九	如意算盘
计策	策略
权术	智术
韬略	战略
巧计	妙计
上策	万全之策
阴谋	诡计
毒计	毒谋
故智	故伎
手段	手腕
高招	绝招
花招	把戏
花头	花枪
冷箭	暗箭
辣手	毒手
理想	志向
幻想	空想
泡影	梦幻泡影
梦幻	梦乡
噩梦	恶梦
志气	意气
意志	心志
干劲	劲头
兴趣	兴味
兴致	兴会
意气	气味
乐趣	生趣
诗兴	诗思
嗜好	爱好
瘾头	瘾
情致	致
韵味	韵致
余韵	遗韵
想法	想头
主意	主见
坏主意	馊主意
见解	见识
卓见	灼见
创见	新意
定见	定盘星
浅见	管见
成见	入主出奴
偏见	偏
异议	异言
人生观	世界观
精华	菁华
宝贝	宝物
财富	遗产
毫毛	鸿毛
赘疣	蛇足
糟粕	草芥
枯木朽株	僵尸
萌芽	胚芽
朝露	昙花
空架子	泥足巨人
大杂烩	杂烩
阻力	阻碍
屏障	屏蔽
挡风遮雨	遮风挡雨
枷锁	约束
诱饵	糖衣炮弹
圈套	钩
护身符	护符
途径	路径
道路	道
长征	万里长征
正路	正道
坦途	阳关大道
邪路	邪道
后门	方便之门
歧路	歧途
老路	覆辙
绝路	末路
近路	捷径
半路	半途
后路	后手
阶	阶梯
敲门砖	垫脚石
致富线	富民路
神	神仙
造物主	上帝
女神	神女
仙女	仙子
圣母	娘娘
天使	安琪儿
上帝	耶和华
基督	耶稣
佛陀	佛
西王母	王母娘娘
观世音	观音
财神	财神爷
阎罗	阎王
土地	土地老
灶神	灶君
凶神	凶神恶煞
鬼	鬼魂
魔鬼	魔
恶鬼	魔王
妖	妖怪
狐仙	狐狸精
魂	魂灵
阴魂	幽魂
英魂	英灵
妖魔鬼怪	魑魅
神怪	神异
天国	天堂
天宫	玉宇
月宫	蟾宫
龙宫	水晶宫
阴间	阴曹
前生	前世
来世	来生
龙	苍龙
蛟龙	蛟
虬龙	虬
凤	凤凰
麒麟	麟
世界	世
第三世界	第三国际
人间	人世
国家	国
全国	通国
中原	华夏
盟国	盟邦
外国	外
邻国	邻邦
万国	列国
大国	泱泱大国
共和国	民主国
王国	帝国
主权国	独立国
属国	藩国
联邦	邦联
本国	我国
省	省份
县	邑
乡	镇
我省	本省
本县	我县
东洋	东瀛
各州	全州
地县	市县
首都	国都
故都	旧都
省会	省城
人种	种族
民族	族
外族	异族
蒙古族	蒙族
哈萨克族	哈萨克
客家人	客家
门巴	门巴族
家族	亲族
皇族	皇室
王室	王族
望族	世族
大族	大户
门第	门户
家庭	家园
全家	合家
书香人家	诗礼之家
寒门	柴门
娘家	岳家
婆家	人家
住户	人家
农户	庄户
富户	首富
小康	小康户
小户	小户人家
舍间	舍下
单门独户	独门独户
户头	户
阶级	阶级性
无产阶级	工人阶级
政党	党
共产党	共
政治	政
朝政	时政
仁政	德政
暴政	虐政
帝国主义	帝
法西斯主义	法西斯
机会主义	冒险主义
帝制	君主专制
议会制	代议制
专政	独裁
政策	策略
制度	制
国际公制	公制
市制	市用制
征兵制	军制
募兵制	志愿兵制
所有制	国体
个体所有制	个体户
非公有	非国有
三资	三资企业
国有	公有
体制	建制
机构	组织
部门	单位
会计室	帐房
教研室	教研组
工段	段
核查组	检查组
维修班	修理班
专修班	研修班
春蕾班	女童班
辅导班	补习班
训练班	培训班
研讨班	研习班
支部	分支部
关系部	公关部
团体	组织
阵营	阵线
红十字	红新月会
群落	部落
黑社会	黑帮
本社	我社
派别	派系
嫡派	嫡系
支派	支系
左派	左翼
右派	右翼
军队	武装部队
雄兵	雄师
貔貅	貔虎
海军	水军
伞兵	空降兵
子弟兵	国民军
解放军	人民解放军
志愿军	中国人民解放军
义师	义军
卫队	禁军
前锋	先锋
两翼	翼侧
援军	救兵
战争	战事
战役	役
激战	苦战
殊死战	死战
堑壕战	壕堑战
闪电战	闪击战
破击战	破袭战
初战	首战
奋战	苦战
内战	内乱
宗教	教
道门	道
佛教	佛门
天理教	八卦教
基督教	新教
天主教	旧教
东正教	正教
伊斯兰教	清真教
婆罗门教	印度教
礼仪	仪式
盛典	大典
洗礼	洗
繁文缛节	殡仪
礼节	礼数
礼貌	礼数
虚礼	俗套
风俗	俗
习惯	习气
陋习	恶习
风气	风尚
时尚	俗尚
家风	门风
世风	世道
妖风	邪气
地位	位置
要津	要路
高位	上位
名位	名分
职位	位置
职守	职掌
差使	差事
官职	功名
岗	哨卡
等级	等第
头衔	衔
设计家	设计师
帝位	大宝
爵位	爵
公爵	公
侯爵	侯
伯爵	伯
子爵	子
男爵	男
事业	业
大业	伟业
行业	行
七十二行	三百六十行
商业	商
工程	工
水利工程	水利
土木工程	土木
职业	工作
兼职	兼差
工作	作业
勤务	勤
总务	庶务
野外工作	田野工作
活计	活路
家务	家事
针线	针线活
手工	细工
农活	农事
劳役	苦工
动作	手脚
着数	招数
举动	行动
善举	善事
阴德	阴功
恶	恶行
私弊	藏掖
行为	行止
暴行	横行
恶行	倒行逆施
权力	权柄
政权	政柄
军权	兵权
职权	事权
权利	权
财产权	产权
责任	责
重任	使命
职责	天职
本分	己任
负担	担子
重负	重担
会议	会
茶话会	茶会
党代会	党代表大会
代表大会	代表会
宴会	酒会
盛宴	国宴
喜筵	喜酒
酒席	宴席
素席	素酒
规则	守则
章程	规章
规定	规程
规矩	轨
常规	成规
空文	一纸空文
陋规	陈规
条约	公约
协定	存照
约据	契约
盟约	盟誓
合同	合约
契	契据
保证书	保证
条款	条目
法律	法度
法制	法纪
宪法	宪
法令	宪
刑法	刑律
此法	本法
纪律	纪
禁	戒
戒律	戒条
罪行	罪名
刑罚	刑
刑法	刑
从刑	附加刑
大刑	重刑
死刑	极刑
凌迟	剐
经济	财经
上市	挂牌
价值	价
价格	价钱
行市	行情
价目	价码
不变价格	比较价格
产业	产
财产	资产
家产	家当
动产	浮财
不动产	恒产
私房钱	私房
财物	财
钱财	资财
洋财	横财
邪财	横财
民脂民膏	血汗钱
资本	资产
股份	股子
财政资本	金融资本
垄断资本	独占资本
利润	赢利
红利	花红
纯利	净利
股息	股利
利息	利钱
年利	年息
月利	月息
高利贷	印子钱
高利	重利
债务	债
宿债	积欠
呆坏账	坏账
货币	钱币
纸币	钞票
辅币	补助货币
银元	银洋
角票	毛票
铜元	铜钱
大钱	大
金条	条子
银两	银子
票据	票
汇票	外汇券
印花税票	印花
邮票	邮花
联运票	通票
有价证券	证券
奖券	彩票
公债券	债券
捐税	捐
田赋	钱粮
苛捐杂税	苛杂
租金	租
工资	工钱
薪水	薪金
月薪	月工资
军饷	饷
俸禄	禄
津贴	补贴
报酬	酬劳
工钱	手工钱
稿费	稿酬
润笔	润资
佣金	佣钱
脚钱	脚力
帐目	账
日记帐	日记账
明细帐	细帐
款项	款子
公款	帑
现款	现钱
进项	进款
收支	进出
盈余	赢余
亏损	亏空
损耗	亏耗
损益	盈亏
公积金	公共积累
罚金	罚款
存款	储蓄
头寸	银根
外快	外水
保证金	保险金
赔偿金	赔偿费
补助金	补助费
成本费	工本费
修理费	维修费
通话费	电话费
代理费	代办费
教育事业费	教育费
费用	费
生活费	日用
伙食费	膳费
学费	学杂费
邮费	邮资
路费	旅费
车钱	车马费
运输费	运费
小费	茶钱
赏钱	喜钱
零用	零花
抚恤金	恤金
文化	文明
仰韶文化	彩陶文化
教育	教
电化教育	电教
兴学	办学
卫生	保健
学说	主义
马克思列宁主义	马列主义
唯物主义	唯物论
历史唯物主义	唯物史观
唯心主义	唯心论
形而上学	玄学
达尔文主义	进化论
中学	国学
学问	学
知识	知
见识	见闻
科学	学
社会科学	人文科学
逻辑学	论理学
音韵学	声韵学
语法学	文法学
医学	医术
中医药学	中医学
学科	课
语文课	国语课
数学课	算术课
理化	生化
外语课	外文课
体育课	体操课
医学	医
中医	国医
小儿科	儿科
牙科	口腔科
学业	课业
习题	练习
课外作业	家庭作业
题目	问题
考题	课题
难题	偏题
考卷	试卷
号码	号子
邮政编码	邮编
条形码	条码
记号	符号
花押	押
杠子	杠
曲谱	谱
标点符号	标点
逗号	逗点
句号	圈
顿号	点
感叹号	惊叹号
删节号	省略号
字	文字
汉字	中国字
俗字	卜辞
古文字	古文
简体字	简化汉字
数目字	数字
金文	钟鼎文
大篆	籀文
小篆	秦篆
隶书	隶字
楷书	正书
朱文	阳文
白文	阴文
别字	白字
盲文	盲字
笔画	笔
横	画
竖	直
挑	剔
捺	磔
偏旁	旁
宝	盖
字母	假名
书体	字体
正体	正字
篆书	篆体
隶书	隶
楷书	正楷
宋体字	老宋体
仿宋体	仿宋
草书	草体
小楷	小字
大楷	大字
词	单词
词语	用语
字句	词句
词组	短语
词汇	语汇
褒义词	褒词
贬义词	贬词
措辞	用语
冗词	冗词赘句
谚语	谚
语助词	语气助词
单纯词	单词
句	句子
佳句	妙句
名句	警句
语言	言语
汉语	华语
外国语	外语
方言	土语
普通话	国语
文学语言	标准语
文艺语言	文学语言
谜语	谜
令	酒令
题材	题目
主题	正题
体裁	样式
布局	格局
情调	色彩
格调	笔调
俗套	老套子
风格	风骨
笔势	笔致
球路	歌路
音律	乐律
目录	目次
书目	书录
细目	子目
戏目	戏码
节目	剧目
内容	情节
细节	底细
字里行间	字字句句
意思	意
意味	寓意
诗情画意	诗意
口气	口风
要点	要端
摘要	撮要
纲要	提纲
概要	梗概
话	言
谈吐	措词
谈锋	话锋
话头	话锋
片言	片言只字
至理名言	至理明言
豪语	豪言壮语
空话	空谈
牛皮	高调
真话	真心话
知心话	私话
常言	常言道
家常话	家常
家乡话	乡谈
口头禅	口头语
客套话	客套
门面话	官话
现成话	滥套子
俗话	俗语
老话	古语
诺言	约言
誓词	誓言
咒语	咒
口诀	歌诀
训词	训话
劝告	忠告
忠言	箴言
遗言	遗教
耳边风	耳旁风
婉言	婉辞
好话	感言
美谈	佳话
赞语	美言
祝词	贺词
笑话	玩笑
谗言	谗
清淡	玄
高帽子	高帽儿
甜言蜜语	花言巧语
怨言	牢骚
流言	流言蜚语
胡话	妄语
怪话	怪论
谎话	谎
闲谈	闲话
絮语	车轱辘话
赘言	废话
粗话	脏话
说白	道白
引子	开场白
台词	戏词
回话	回音
梦话	梦呓
急口令	绕口令
口号	标语
切口	黑话
口供	供词
寡言少语	少言寡语
一番话	一席话
此言	此话
说法	讲法
言论	论
老调	滥调
论调	调调
讲经说法	论道
评论	评说
舆论	舆情
众说	杂说
估测	测评
建议	提议
结论	定论
决定	决议
命令	命
军令	将令
指令	训令
圣旨	谕旨
兵符	符
通知	通牒
布告	通告
檄文	檄书
启事	告白
喜报	报单
光荣榜	红榜
讣告	讣闻
报告	汇报
奏章	奏疏
便条	条子
回条	回帖
招贴	招子
签	浮签
皮带	小抄儿
病假条	假条
处方	配方
单方	丹方
成方	验方
说明书	仿单
信	函
家信	家书
来信	来函
回信	复信
贺信	贺函
手书	亲笔信
黑信	恐吓信
公函	文牍
信件	函件
检举信	举报信
感谢信	表扬信
邀请函	邀请信
投诉信	上告信
电报	电
传真电报	传真
加急电报	特急件
资料	材料
文件	文书
档案	档
案卷	案
卷宗	卷
照会	照
判决书	判词
悔过书	检讨书
诉状	状子
供状	供词
遗嘱	遗书
修改案	修正案
抄件	复印件
图	图形
地图	地形图
正视图	正面图
侧视图	侧面图
顶视图	俯视图
频谱	频带
表	表格
视力表	目力表
正误表	勘误表
坐位表	座位表
课程表	课表
作品	作
巨著	鸿篇巨制
杰作	佳作
处女作	出世作
拙作	拙笔
急就章	即兴之作
遗著	遗书
手迹	手笔
断编残简	片纸只字
文章	篇
社论	社评
论文	舆论
八股文	制艺
札记	摘记
祭文	诔
碑文	碑记
墓碑	神道碑
墓志	墓志铭
行状	行述
文言文	文言
白话文	语体文
应用文	实用文
记叙文	叙事文
说明文	论说文
骈文	四六文
上下文	前后文
辞章	词章
下卷	下篇
稿件	稿子
草稿	草
初稿	未定稿
底稿	稿本
书籍	书本
丛书	丛刊
四库	经史子集
历书	通书
史书	史籍
兵书	兵符
古书	古籍
经书	经籍
方志	地方志
集子	集
读本	课本
字帖	习字帖
画帖	画谱
连环画	小人儿书
书背	书脊
版本	本子
珍本	秘本
样本	范本
正本	原本
副本	复本
页张	页
封面	封皮
报章	报纸
墙报	壁报
杂志	期刊
周刊	周报
特辑	特刊
报刊	报章杂志
书刊	书报
序言	序文
引言	小引
导言	绪论
本文	正文
结语	结束语
跋	跋文
序跋	题跋
按语	按
批语	批
眉批	批注
引文	引语
注解	注释
凡例	例言
备考	备注
经典	经
经文	经典
佛经	释典
旧约	新约
文学	文艺
新文学	白话文学
口头文学	说唱文学
小说	小说书
剧本	台本
散文	散记
小品	小品文
漫笔	随笔
传记	传
杂记	笔记
记录	记要
报道	通讯
日志	日记
图说	图鉴
纪行	游记
访问记	采访记
诗	诗歌
古体诗	古诗
史诗	诗史
律诗	律
绝句	绝
旧诗	旧体诗
新诗	白话诗
民歌	民谣
儿歌	童谣
赞美诗	赞美歌
即兴诗	口号
词	长短句
赋	辞赋
令	小令
曲	散曲
对联	楹联
门联	门对
对子	对
春联	桃符
音乐	乐
下里巴人	民乐
交响乐	交响诗
歌	歌曲
情歌	恋歌
哀歌	悲歌
夯歌	号子
船歌	船夫曲
曲	曲子
序曲	前奏曲
尾声	煞尾
小调	小曲
催眠曲	摇篮曲
戏剧	戏
戏曲	曲
歌剧	歌舞剧
话剧	文明戏
京剧	京戏
昆剧	昆曲
婺剧	金华戏
越剧	绍兴戏
粤剧	广东戏
豫剧	河南梆子
秦腔	陕西梆子
晋剧	山西梆子
闽剧	福州戏
评剧	落子
沪剧	申曲
淮剧	江淮戏
闹剧	笑剧
武戏	武剧
木偶戏	傀儡戏
皮影戏	影戏
看家戏	拿手好戏
唱段	选段
唱腔	腔调
昆腔	昆曲
梆子腔	梆子
二黄	二簧
舞蹈	舞
芭蕾舞	芭蕾
龙舞	龙灯
跑旱船	采莲船
太平鼓	羊皮鼓
电影	影戏
无声片	默片
动画片	卡通
音像	声像
镜头	画面
广角镜头	长镜头
大鼓	鼓书
铁板大鼓	铁皮大鼓
道情	渔鼓
莲花落	落子
说书	说话
评弹	弹词
滑稽戏	独脚戏
河南坠子	坠子
杂技	把戏
魔术	幻术
武术	国术
柔道	柔术
拳术	拳脚
绘画	美术
插画	插图
国画	中国画
西洋画	西画
漫画	卡通
宣传画	招贴画
屏条	屏
木刻	木版画
字画	书画
雕刻	雕像
塑像	泥塑
佛像	佛
照片	相片
小照	小影
遗照	遗像
全家福	合家欢
像	形象
画像	肖像
疾病	病症
沉疴	沉痼
急症	急病
险症	重症
绝症	死症
瘟疫	疫病
时令病	时令
并发症	合并症
内伤	暗伤
炎症	炎
结核病	结核
精神病	神经病
性病	花柳病
梅毒	杨梅
贫血	血枯病
肺结核	肺病
尘肺	灰尘肺
胸膜炎	肋膜炎
肝硬变	肝硬化
疟疾	冷热病
伤寒	肠伤寒
霍乱	虎疫
痢疾	痢
变形虫痢疾	阿米巴痢疾
流行性感冒	流感
中暑	日射病
对眼	斗眼
麦粒肿	针眼
青光眼	内障
白内障	内障
斑秃	鬼剃头
麻风	癞
荨麻疹	风疹块
湿疹	湿气
白癜风	白斑病
癔病	歇斯底里
脑炎	大脑炎
癫痫	羊痫风
瘫痪	疯瘫
产褥热	月子病
阑尾炎	盲肠炎
流行性腮腺炎	痄腮
丝虫病	血丝虫病
鼠疮	瘰疬
高山病	山晕
疝气	小肠串气
呆小症	克汀病
走马疳	牙疳
不孕	不孕症
失眠病	失眠症
艾滋病	爱滋病
风湿	类风湿
甲亢	甲亢病
妇科病	妇女病
旧病	老毛病
牛瘟	烂肠瘟
黑穗病	黑粉病
黄锈病	黄疸
锈病	锈
外伤	金疮
带伤	有伤
伤口	创口
肿瘤	瘤
毒瘤	恶性肿瘤
癣	顽癣
头癣	秃疮
花斑癣	汗斑
手癣	鹅掌风
脚癣	脚气
疮	疡
疥疮	疥
痈	痈疽
疔	疔疮
砍头痈	砍头疮
脓包	脓肿
疖子	疖
痂	疮痂
痔	痔疮
趼子	趼
痣	痦子
癍	斑痕
寿斑	老人斑
记	胎记
粉刺	痤疮
雀斑	黄褐斑
疣	肉赘
疙瘩	圪塔
茧	茧子
政府	内阁
机关	机构
看守内阁	看守政府
朝廷	宫廷
官府	官厅
枢要	枢机
行政公署	行署
大使馆	使馆
总领事馆	总领馆
总政治部	总政
计生委	计委
国家教委	教委
中央军委	军委
航天局	宇航局
国税局	税务局
林管局	林业局
物资局	国资局
邮电局	邮局
高法	最高人民法院
检察院	人民检察院
法院	人民法院
法庭	庭
公安局	警察局
监狱	牢狱
工厂	厂子
矿	工矿
工场	作坊
磨坊	碾坊
酱园	酱坊
商店	铺子
总店	总行
分店	分行
摊	摊子
中药店	药铺
西药店	药房
书店	书局
理发店	理发馆
饭店	饭馆
酒店	酒家
小吃店	小吃部
旅馆	店
茶馆	茶楼
当铺	当
裁缝店	成衣铺
布店	布庄
杂货店	杂货铺
浴室	浴池
银行	钱庄
代办点	代理点
照相馆	摄影部
杂食店	食杂店
快餐馆	快餐店
咖啡馆	咖啡厅
工商行	工行
营业厅	营业室
中国人民银行	中国银行
世界银行	世行
中央银行	央行
集团公司	集团
非国有企业	私企
实体	实业
学校	校
私塾	学塾
义学	义塾
高等学校	大学
学院	院
专科学校	专科
附属中学	附中
高级中学	高中
初级中学	初中
附属小学	附小
高级小学	高小
初级小学	初小
完全小学	完小
幼儿园	幼稚园
师范学校	师范
大专学校	大专院校
职高	职业高中
医科院	医学院
大职校	职校
医院	卫生院
产院	妇产科
精神病院	疯人院
救护所	庇护所
疗养院	休养院
敬老院	养老院
电影院	影院
剧院	剧场
剧团	剧院
文工团	歌舞团
体育场	运动场
舞场	舞厅
文化宫	文化馆
博物馆	博物院
报社	报馆
电台	无线电台
联社	联合社
速度	速
声速	音速
音强	音势
地震烈度	烈度
抗张强度	抗拉强度
精密度	精度
高度	高
海拔	高程
深度	深
厚度	厚薄
宽度	宽窄
个头	个儿
长度	长
尺码	尺寸
缩尺	比例尺
浓度	浓淡
重量	分量
负荷	负载
音量	响度
光度	灯光
工资分	工分
频道	频段
声望度	知名度
温度	温
地温	土温
烧	热
燃点	着火点
距离	间隔
路程	行程
规程	回程
波幅	振幅
数量	数
总数	总额
余数	仂
人数	人头
字数	篇幅
整数	平头
尾数	尾子
答数	得数
和数	和
差数	差
乘积	积
乘方	乘幂
偶数	双数
奇数	单数
分数	分
零数	零头
函数	因变量
逆函数	反函数
因数	因子
等差级数	算术级数
等比级数	几何级数
自变数	自变量
十进对数	常用对数
无穷大	无限大
无穷小	无限小
方根	根
常量	恒量
当量	化学当量
食量	饭量
空额	缺额
一	壹
二	贰
三	叁
四	肆
五	伍
六	陆
七	柒
八	捌
九	玖
十	什
廿	念
百	佰
千	仟
亿	垓
零	洞
第一	头
第二	二
第三	三
第四	四
半	一半
过半	大半
小半	少数
概数	约数
几	数
内外	上下
多	出头
不到	近
若干	多少
倍数	倍
成数	成
折扣	折头
比率	率
概率	几率
比例	比
正比例	正比
反比例	反比
比重	比例
数量单位	标准单位
群	帮
排	进
串	挂
堆	团
叠	沓
丛	束
掐	把
绺	缕
捆	荮
抱	捧
绞	股
担	挑
身	套
袭	领
对	双
种	样
各	个
个	只
栋	座
层	级
棵	蔸
架	台
辆	部
家	户
丘	片
张	纸
匹	头
尾	条
颗	粒
幅	帧
艘	只
枝	条
册	本
帙	部
首	篇
餐	顿
股	剂
桌	席
扇	樘
摊	汪
道	条
件	码
批	票
回合	合
回	章
截	段
派	片
线	丝
班	趟
客	份
枚	朵
千伏安	千瓦
车皮	专列
次	度
周	圈
阵	阵子
下	记
中纬度	经纬度
公尺	米
盎司	英两
长	漫长
细长	狭长
短	短小
高	万丈
修长	颀长
高耸	突兀
高大	魁梧
矮	锉
矮小	短小
矮胖	矮墩墩
大	巨
宽大	肥大
大型	巨型
大而无当	重特大
中	中等
小	微
小型	微型
广阔	宽阔
滔滔	咪咪
宽敞	宽阔
狭窄	窄
深	幽
浅	浅水
厚	厚实
薄	单薄
扁	扁平
粗	粗大
细	纤细
胖	肥
丰满	丰盈
臃肿	虚胖
大腹便便	脑满肠肥
瘦	清瘦
憔悴	枯槁
直	笔直
曲	曲折
委曲	迂曲
拳曲	蜷曲
九折	九曲回肠
平	平行
挺	笔挺
皱	纵
正	端正
歪	歪斜
规则	平整
参差	参差不齐
嶙峋	嶙峋
尖	尖锐
秃	钝
凸	穹隆
石拱	拱券
凹	凹陷
平坦	平缓
崎岖	起伏
凹凸不平	高低不平
陡峭	陡
高峻	陡峻
方	正方
长方	矩形
圆	浑圆
椭圆	长圆
半圆形	弧形
半月形	弯月形
多	许多
大量	大批
如林	如云
济济	芸芸
一连串	一系列
擢发难数	罄竹难书
少	少数
寥寥可数	寥寥无几
少量	小量
丝毫	秋毫
繁多	万端
纷繁	繁杂
稀少	希少
单	只
双	偶
全部	全体
部分	有些
少数	个别
多数	大部分
密	稠
疏	稀
冲散	打散
茂盛	旺盛
葱翠	葱茏
茂密	森然
荒芜	荒废
肥沃	肥美
贫瘠	瘠薄
空	空
空心	秕
实	实心
满	满登登
饱满	饱
满座	客满
满街	满城风雨
光秃秃	秃
完整	完全
齐全	齐备
残缺	欠缺
残破	秃
残存	残留
零碎	细碎
破烂	破碎
鹑衣百结	捉襟见肘
冗长	长
简短	短小
紧	严
松	泡
硬	坚
板	板结
软	柔
烂	酥
脆	松脆
牢	固
韧	坚韧
浓	厚
稠	糨
黏	黏糊
稀	薄
重	沉
轻	轻飘
笨重	粗重
轻巧	精巧
轻快	轻飘
锋利	利
钝	不快
生	生涩
熟	熟透
嫩	鲜嫩
响	高
雷鸣	雷动
轻	细
尖	尖利
粗	粗重
沙哑	嘶哑
低沉	深沉
悦耳	入耳
婉转	缠绵
清脆	脆
难听	刺耳
亮	明
耀眼	夺目
炯炯	灼灼
皎洁	皎皎
光洁	晶莹
油光	油汪汪
荧荧	熹微
暗	阴暗
背阴	背光
幽幽	幽然
黑暗	昏黑
清澈	清亮
透明	透亮
浑浊	混浊
清晰	明晰
模糊	糊涂
远	遥
偏远	边远
远程	远道
近	在望
邻近	邻
短途	短距离
以近	远近
早	早日
初	新
迟	晚
暮	残
夜深	夜深人静
快	速
如梭	跌进
疾驰	一溜烟
光阴似箭	日月如梭
不胫而走	不翼而飞
急转直下	一泻千里
不假思索	一目十行
指日可待	计日程功
迅疾	急速
慢	缓
频率	效率
长久	久长
多年	有年
整年	通年
整天	终天
整夜	通夜
日日夜夜	日以继夜
半晌	半天
永远	永世
短促	短暂
一会儿	会儿
一眨眼	一转眼
暂时	临时
冷	寒冷
清寒	冷飕飕
苦寒	严寒
寒湿	发潮
饥寒	饥寒交加
热	热火
烫	滚烫
炎热	炎炎
凉	凉快
暖	温
冷热	寒热
凉爽	爽
闷气	闷热
干燥	干
干枯	焦枯
干涸	干旱
潮湿	濡湿
湿	湿淋淋
滋润	润泽
新	簇新
新式	新颖
时鲜	应时
新鲜	鲜
旧	陈旧
老式	过时
古老	古
古朴	古拙
美丽	漂亮
秀美	秀气
华丽	富丽
鲜艳	浓艳
妖艳	妖冶
娇	娇媚
绚丽	绚烂
锦绣	入画
美貌	标致
俊美	俊秀
翩翩	袅娜
丑陋	难看
雅致	雅观
洋气	洋
土气	土
豪华	华
奢华	浮华
铺张	排场
朴素	纯朴
璞玉浑金	浑金璞玉
简陋	陋
光滑	光
毛糙	粗糙
精巧	细巧
讲究	考究
粗糙	毛糙
人造	人工
自动	机动
雄	公
男	男性
雌	母
女	女性
年老	老
垂暮	垂垂老矣
长寿	高寿
年轻	后生
幼小	幼稚
健康	康健
鹤发童颜	老当益壮
孱弱	衰弱
无力	绵软
病恹恹	恹恹
红	赤
淡红	浅红
粉红	桃红
大红	绯红
深红	暗红
黄	蜡黄
淡黄	牙色
米黄	米色
杏黄	橙黄
金黄	金色
土黄	藤黄
蓝	蔚蓝
淡蓝	葱白
深蓝	湛蓝
藏蓝	品蓝
藏青	海军蓝
青	苍
淡青	蛋青
蟹青	铁青
苍苍	黛色
绿	碧
嫩绿	淡绿
深绿	墨绿
紫	绀青
雪青	青莲色
赭	红褐色
浅棕	驼色
褐	栗色
深褐色	古铜色
白	粉
苍白	惨白
花白	斑白
灰	灰溜溜
深灰	暗灰
黑	青
深	浓
淡	嫩
鲜艳	花哨
五彩	彩色
斑斓	光怪陆离
斑驳	斑驳陆离
素净	素
香	喷香
浓郁	郁郁
臭	荤
狐臭	狐臊
腥	腥气
膻	腥膻
臊	臊气
甜	甘
酸	酸溜溜
苦	苦口
涩	苦涩
辣	辛
咸	咸津津
淡	薄
可口	美味
难吃	倒胃口
醇厚	浓厚
醇和	清醇
油腻	腻
清淡	寡
真实	实
十足	十分
名副其实	有名有实
虚假	虚
名义	挂名
假想	假设
有名无实	名过其实
言不由衷	心口不一
外强中干	羊质虎皮
确实	实
虚妄	无稽
影响	靠不住
捕风捉影	镜花水月
渺茫	渺
逼真	乱真
疑似	似是而非
失真	走样
好	优
高超	高强
精湛	深湛
到家	过硬
瑰玮	瑰丽
锦心绣口	文不加点
龙飞凤舞	好戏连台
字正腔圆	余音绕梁
浮艳	艳
优越	优胜
三好	品学兼优
坏	差
不成话	要不得
恶劣	低劣
杰出	突出
不凡	非凡
空前	划时代
盖世	无双
异常	非常
奇崛	独到
特定	一定
专门	专
唯一	绝无仅有
普通	一般
合格	够格
象样	不错
瑕不掩瑜	大醇小疵
上等	上品
高等	高级
头等	头号
超等	超级
中等	中档
平平	平常
下等	劣等
困难	艰难
艰巨	繁重
艰险	险
容易	简易
深奥	深邃
玄妙	奥妙
费解	百思不解
浅近	浅显
工整	工稳
通顺	通畅
晦涩	生涩
实际	现实
实至名归	名符其实
空洞	空虚
全面	全盘
周密	严密
片面	管窥
正确	对
准确	准
箭不虚发	有的放矢
中肯	一语破的
错误	错
不足为凭	不足为训
笔误	误字
合理	有理
名正言顺	理直气壮
无理	理亏
生硬	勉强
牵强	凿空
勉强	将就
固定	恒定
不变	静止
改头换面	换汤不换药
灵活	活
生动	潇洒
平板	凝滞
猛烈	剧烈
致命	沉重
无情	毫不留情
大张旗鼓	雷厉风行
尖锐	尖利
过激	偏激
柔和	平和
深刻	深入
高度	莫大
深远	远大
深厚	深切
恩同再造	恩重如山
深沉	沉沉
淡薄	淡漠
肤浅	浮浅
轻微	微薄
细腻	细致
粗疏	粗线条
稳固	牢固
强大	强硬
强盛	富强
弱小	软弱
伟大	伟
渺小	藐小
威武	威严
雄壮	雄伟
居高临下	高屋建瓴
险要	险阻
雄健	稳健
奔放	豪放
光明	美好
清明	修明
赏罚分明	信赏必罚
黑暗	暗无天日
腐败	腐化
光荣	荣耀
不朽	永垂不朽
衣锦还乡	荣宗耀祖
可耻	羞耻
著名	闻名
人心所向	众望所归
无名	默默无闻
热门	吃香
冷门	冷
赢家	胜者
占上风	占优势
尊贵	高贵
贵	尊
低贱	卑微
敝	鄙
贵重	名贵
奇货可居	价值连城
一刻千金	寸土寸金
昂贵	腾贵
便宜	贱
重要	紧要
中心	主导
次要	其次
不足道	微不足道
不要紧	没关系
无伤大雅	无伤大体
紧急	紧迫
严重	惨重
惊人	可惊
必要	必需
多余	富余
熟识	熟悉
陌生	生疏
亲密	密切
唇亡齿寒	唇齿相依
鸾凤和鸣	鸳鸯戏水
儿女情长	两小无猜
依恋	缠绵
疏远	生疏
若即若离	不即不离
和睦	和气
不和	不对
敌对	不共戴天
紧密	严密
松散	疏松
单纯	单一
复杂	繁杂
说来话长	一言难尽
重叠	臃肿
琐碎	琐细
烦琐	繁芜
简单	简略
详细	详尽
透彻	透辟
均匀	匀称
调和	调匀
平衡	失衡
广泛	广阔
无穷	无限
狭隘	狭窄
丰富	丰厚
广博	渊博
贫乏	缺乏
可爱	喜人
明媚	柔媚
动人	感人
可怕	怕人
可憎	可恶
伤	腻
深恶痛绝	千夫所指
刺眼	碍眼
刺耳	难听
可怜	可怜巴巴
可笑	好笑
有趣	风趣
滑稽	好笑
带劲	有劲
枯燥	干燥
正常	如常
反常	失常
怪癖	特别
奇怪	古怪
神奇	神异
不伦不类	不三不四
不可思议	天晓得
可疑	有鬼
公开	公然
明目张胆	明火执仗
秘密	机密
暗中	暗暗
合法	法定
非法	不法
明显	显明
含糊	含糊
隐约	隐隐
顶用	有用
万能	全天候
两用	两栖
有功	功勋
无用	无效
口惠	只说不做
徒劳	枉然
无偿	义务
便利	便当
手提式	手提
不便	麻烦
恰当	适当
各得其所	因地制宜
适时	及时
切题	照理
合身	称身
适口	合口味
失当	不当
文不对题	不妥
屈才	大材小用
以珠弹雀	明珠弹雀
妥当	妥善
可靠	牢靠
天然	自然
天衣无缝	行云流水
本来	原来
现成	现
外来	外路
国产	国
土产	土
正规	正式
业余	非正式
课余	课外
杂牌	杂色
分内	本分
分外	格外
公	公共
村务公开	半公开
私	私房
总	主
分	支
御	钦
皇	国
禅	梵
胞	同胞
堂	堂房
表	中表
姑表	姑舅
姻	内
寄	养
继	后
庶	旁支
师	砚
盟	把
这个	这
那个	那
某个	某
各个	各
其他	其它
异	他
何	什么
善良	善
仁慈	仁爱
凶恶	凶狠
恶毒	狠毒
人面兽心	狼心狗肺
罪恶	万恶
祸国殃民	草菅人命
凶残	残酷
阴险	险恶
厚道	忠厚
刻薄	苛刻
嘴尖	贫嘴
缺德	不仁
正直	耿直
坦率	坦白
直率	率直
豪爽	爽朗
嘴快	心直口快
婉转	委婉
转弯	绕圈子
含糊其辞	支吾其词
话里有话	意在言外
诚实	老实
刁滑	狡猾
势利	势利眼
真诚	热诚
虚伪	伪善
忠诚	忠
叛逆	忤逆
温柔	温和
暴躁	暴烈
温顺	和顺
听话	听说
孝顺	孝
倔强	倔
不甘	不甘心
乖僻	乖张
乐观	乐天
悲观	想不开
严肃	严厉
活泼	活跃
顽皮	调皮
潇洒	洒脱
豪放	不羁
拘束	拘谨
消遥	自在
安分	本分
放肆	放纵
散漫	疏懒
放荡	荒唐
果断	决断
坚强	刚强
刚柔相济	绵里藏针
坚定	坚
脆弱	软弱
勇敢	勇
有勇有谋	大智大勇
怯懦	怯弱
聪明	聪慧
过目不忘	过目成诵
英明	明智
愚笨	笨拙
糊涂	悖晦
机智	机灵
鲁钝	迟钝
圆滑	浑圆
滑头	油
油嘴	油腔滑调
刻板	古板
教条	机械
固执	执拗
灵巧	灵活
心灵	眼尖
能干	精干
全能	万能
善战	以一当十
妙手回春	手到病除
健谈	对答如流
独具慧眼	独具只眼
出口成章	文不加点
无能	低能
博学	饱学
浅学	浅薄
孤陋寡闻	少见多怪
无知	蒙昧
有为	成器
不成材	不成器
卓有远见	目光如炬
目光如豆	目光短浅
老练	干练
幼稚	天真
少不更事	羽毛未丰
熟练	纯熟
生疏	夹生
荒疏	荒
积极	主动
消极	被动
勤奋	勤勉
闲不住	戴月披星
用功	用心
懒惰	懒
拖拉	拖沓
有恒	恒久
无恒	有始无终
节约	节省
奢侈	浪费
认真	顶真
马虎	含糊
仔细	细
粗心	粗
毛手毛脚	没头没脑
谨慎	勤谨
口紧	嘴紧
慎重	郑重
知趣	识趣
轻率	鲁莽
荒唐	荒诞
稳重	稳健
踏实	塌实
轻浮	浮
耐心	耐性
苦心	煞费苦心
急躁	浮躁
文雅	风雅
粗暴	粗鲁
清高	孤高
虚荣	好胜
恭敬	虔敬
敬老	尊老敬老
客气	殷勤
简慢	怠慢
热情	热心
冷淡	冷漠
谦虚	谦逊
深藏若虚	大智若愚
自卑	卑
恭顺	低声下气
骄傲	骄矜
引以自豪	成就感
大度	大量
慷慨	慨然
够交情	够朋友
手松	大方
心窄	小心眼
吝啬	悭吝
严格	严厉
军令如山	执法如山
宽大	宽
革命	红色
反动	反革命
进步	先进
急进	激进
落后	后进
民主	群言堂
专制	独裁
讲理	通达
蛮横	强横
开通	开展
保守	守旧
公正	正义
严明	明镜高悬
偏心	偏
无私	大公无私
克己奉公	枵腹从公
舍己为人	舍己救人
先人后己	吃苦在前
自私	私
廉洁	清廉
贪心	贪
见钱眼开	财迷心窍
贪财	贪多
高尚	高贵
正派	正经
庸俗	粗俗
下流	下作
贞洁	贞烈
纯洁	高洁
轻佻	轻薄
淫荡	淫乱
色情	香艳
多情	痴情
薄情	喜新厌旧
无情	负心
太平	升平
和平	相安无事
安定	平安
动荡	波动
混乱	纷乱
繁荣	景气
萧条	冷淡
凋敝	凋零
天下兴亡	千古兴亡
热闹	繁华
熙熙攘攘	熙来攘往
喧哗	闹
拥挤	挤
安静	恬静
荒凉	荒僻
凄凉	苍凉
背	僻
冷落	冷清
孤单	孤
寂寞	落寞
繁忙	忙
匆忙	匆促
空闲	悠闲
赋闲	休闲
舒服	舒坦
艰苦	艰辛
安全	安好
治安	有警必接
危险	危
大敌当前	腹背受敌
幸福	福
喜庆	喜
悲惨	凄惨
满目疮痍	疮痍满目
离合悲欢	悲欢
和缓	缓和
紧张	吃紧
庄严	庄重
清洁	干净
肮脏	龌龊
蓬头垢面	囚首垢面
整齐	整
井然	井然不紊
杂乱	混乱
蓬松	枝蔓
一窝蜂	一锅粥
乱糟糟	乱腾腾
富裕	富有
小康	温饱
贫穷	贫
困难	艰难
身无长物	别无长物
打	击
毒打	痛打
敲打	打击
捶打	捶
砸	捣
拷打	拷
抽打	鞭打
扑打	扑
磕打	摔打
打耳光	掌嘴
还击	还手
拍	拊
拍打	扑打
拍手	拍巴掌
抚摩	摩挲
搔	抓
摸	摸出
拉	拉扯
推	排
拖	拖曳
扛	荷
挑	担
抬	抬杠
背	驮
举	擎
托	把
高举	扬
振臂	攘臂
举杯	把酒
捧	掬
揿	按
掐	扼
压	挤压
压榨	榨
滚压	轧
撑	支
拿	持
把握	把
抓	绰
提	拎
出具	出示
撮	拈
揪	扭
夹	挟
搀	扶
挽	牵
抱	搂
合抱	合围
拔	擢
摘	采
剥	扒
撕	扯
抽	掣
折	撅
掰	劈
挖	剜
刳	掏空
剔	挑
钳	夹
填	堵
埋	掩埋
埋葬	葬
塞	掖
插	栽
嵌	镶
衬	垫
放	搁
竖立	立
下	投
堆	垛
叠	折
挂	吊
铺	摊
盖	遮盖
掀	揭
捋	攘
仍	掷
接	承
拾	拾取
松手	放手
包	裹
装	盛
卷	挽
捆	扎
五花大绑	红绳系足
栓	拴
扣	系
打结	系
绞	拧
绕	络
穿	穿着
披挂	身披
戴	冠
佩带	佩
脱	褪
脱帽	免冠
解	松
拆	拆除
涂	涂饰
糊	刮
贴	粘
裱	裱褙
洗	浣
洗澡	沐浴
搓澡	搓洗
刷洗	洗刷
冲洗	冲
荡	涮
浆洗	浆
扫	扫除
清扫	大扫除
擦	拭
磨	钢
揉	揉搓
捻	搓
捞	打捞
舀	打
灌	注
汲	吸
浇	淋
洒	泼
沏	冲
斟	倒
筛	罗
簸	扬
滤	淋
搅拌	拌和
搀和	搀杂
掭	膏
切	铡
切片	片
削	修
割	拉
剖	破
剪	推
修剪	修
刻	雕刻
砍	斩
乱砍滥伐	滥伐
伐树	伐木
刮	刮削
戳	捅
刺	搠
戳穿	剌
碰	触
翻	倾
倾倒	放
扇	鼓
撒	播
开	打开
关	关闭
上锁	锁
搬动	挪动
摇动	摇撼
扇动	振
抖动	抖搂
挥动	挥舞
招手	招
拨动	扒拉
扒	扒拉
扳动	扳
摆弄	弄
玩弄	戏弄
揉	团
弹起	反弹
比画	比
指点	指画
袖手	揣手儿
握手	拉手
走	行
拔腿	拔脚
止步	却步
步行	徒步
阔步	纵步
小步	碎步
快步	疾步
慢走	踱
散步	溜达
漫步	信步
闲逛	游逛
蹒跚	踉跄
扭	折腰
徘徊	盘旋
蹑	溜
登高	登
蹑手蹑脚	轻手轻脚
大摇大摆	高视阔步
踏遍	走遍
跑	驱
狂奔	飞奔
驰骋	驰驱
飞驰	奔驰
跳	跳跃
连跑带跳	跑跑跳跳
踢	踹
踩	踏
跺脚	跳脚
踮	跷
抬脚	起脚
坐	坐坐
端坐	正襟危坐
席地而坐	后坐
盘腿	趺坐
打坐	入定
入座	落座
蹲	踞
立	站
伫立	伫
直立	兀立
站稳	站住
起立	站起
骑	跨
跨	迈
越	翻
抬头	昂首
低头	垂头
回头	回首
点头	颔首
睁眼	张目
瞪眼	瞪
闭眼	合眼
眯眼	眯缝
眨眼	眨巴
飞眼	使眼色
皱眉	皱眉头
撅嘴	努嘴
接吻	亲吻
看	瞧
注视	凝视
端详	端量
展望	瞻望
了望	眺望
环视	扫视
鸟瞰	俯瞰
仰望	仰视
张望	顾盼
回眸	回顾
极目	纵目
正视	目不斜视
斜视	乜斜
怒视	瞪
对视	目视
窥探	窥见
瞥	扫
白眼	白
浏览	溜
看见	瞧见
目睹	目击
望风	把风
一窥全豹	一斑窥豹
看起来	看上去
听	收听
倾听	聆听
偷听	窃听
听见	闻
听说	耳闻
嗅	闻
闻到	嗅到
吃	食
摄食	吃光
内服	口服
啄	塞
嚼	咀嚼
咽	哙
吮	吸吮
喝	饮
喝酒	饮酒
豪饮	狂饮
酗酒	纵酒
饮茶	喝茶
叼	含
舔	舐
咬	噬
叮	螫
呼	哈
送气	嘘气
吐	唾
喷	喷气
吸	抽
呼吸	透气
做声	发音
呻吟	哼
吧嗒	吧唧
呼唤	呼
吹口哨	打口哨
喊	呼
大叫	号叫
吆喝	咋呼
吼	咆哮
欢呼	喝彩
喝倒彩	嘘
哀鸣	哀号
叫	鸣
吼叫	吼
飞	飞翔
高举	飞腾
翻飞	翩翩
蠕动	蠕蠕
倾	倾斜
靠	倚
偎	偎依
躺	卧
躺下	卧倒
仰卧	平卧
静卧	安卧
趴	卧
弯腰	哈腰
欠身	欠
伸腰	伸懒腰
蜷曲	蜷
前仰后合	前俯后仰
打滑	滑
跌倒	摔倒
跌交	摔交
仆	踣
失脚	失足
打前失	马失前蹄
发抖	颤抖
颤悠悠	颤颤巍巍
打滚	翻滚
倒立	拿大顶
翻跟头	滚翻
跟头	斤斗
翻身	辗转
爬	爬行
蜿蜒	蛇行
爬山	登山
攀	爬
钻	钻进
冲	闯
奔突	狼奔豕突
挤	挤挤
行礼	敬礼
鞠躬	折腰
裣衽	拜拜
还礼	回礼
下跪	跪
磕头	叩头
膜拜	顶礼膜拜
高兴	开心
狂喜	销魂
开颜	喜形于色
欢腾	欢跃
欣幸	庆幸
悲喜交集	惊喜交集
悲伤	伤悲
悲痛	哀痛
痛苦	痛
辛酸	酸辛
凄惨	凄楚
兔死狐悲	物伤其类
忧愁	发愁
忧虑	焦虑
忧闷	愁闷
过虑	杞人忧天
烦闷	烦心
憋屈	委屈
愤怒	恼怒
惹气	怄气
动火	动肝火
震怒	盛怒
泄恨	泄愤
息怒	消气
得意	抖
惆怅	怅惘
失意	向隅
灰心	丧气
消沉	低沉
颓丧	颓废
失望	大失所望
扫兴	败兴
计划	筹划
筹措	运筹
策划	谋划
打算	算计
满意	惬意
满足	知足
舒畅	宽畅
轻松	自在
畅	敞
不满	遗憾
不平	鸣不平
心安	安心
自慰	聊以自慰
瞑目	九泉瞑目
不安	紧张
惭愧	羞愧
难为情	不好意思
抱歉	抱愧
心虚	虚
无愧	不愧
镇静	沉着
从容	不慌不忙
心静	平静
安稳	落实
慌张	发慌
着急	焦急
急切	迫切
殷切	殷殷
决意	决心
犹豫	犹疑
三心二意	见异思迁
无奈	无可奈何
奈何	无奈何
无法	没辙
山穷水尽	日暮途穷
被迫	逼上梁山
抓瞎	抓耳挠腮
难堪	好看
警惕	警觉
麻痹	松懈
疏忽	大意
专心	悉心
分心	心不在焉
沉迷	着迷
陶醉	心醉
迷惑	迷惑
留恋	贪恋
习惯	惯
上瘾	成瘾
吃不服	吃不来
醒悟	觉悟
懂事	记事儿
惊奇	奇怪
害怕	惧怕
忧惧	吓坏
后怕	余悸
惊恐	惶恐
受惊	吃惊
畏缩	畏忌
怕生	认生
怯场	怯阵
敬畏	敬而远之
激动	冲动
兴致勃勃	津津有味
感动	感
触动	动心
感激	纫
感恩	感恩戴德
想象	设想
空想	玄想
思考	思量
浮想联翩	心血来潮
幽思	深思
冥想	凝思
尽心竭力	煞费苦心
苦心	刻意
设法	想法
随想	随感
悟出	想开
斟酌	酌
着想	设想
存心	居心
感到	感觉
发觉	发现
认为	以为
主张	主持
坚持	执
推测	揣测
臆断	臆测
因小见大	尝鼎一脔
估计	估量
猜想	猜测
预料	逆料
料到	料及
预测	预计
希望	企望
渴望	热望
向往	神往
祈求	企求
要求	渴求
求得	邀
求全	苛求
追求	探求
谋求	谋
回忆	追忆
怀念	思念
深思	渴念
思乡	乡思
念旧	怀旧
悼念	追悼
挂念	悬念
记得	记
记住	记取
介意	在心
忘记	忘掉
了解	理解
有底	有数
看透	看穿
觉察	察觉
知悉	悉
明知	明理
探悉	获悉
熟悉	熟稔
贯通	精通
顿开茅塞	茅塞顿开
路人皆知	人所共知
懂法	知法
认识	认得
相识	相知
体会	体味
领会	理会
不解	不详
一知半解	似懂非懂
误会	误解
喜欢	喜爱
爱	喜爱
恋	爱恋
溺爱	偏爱
倾心	动情
相好	相爱
敬业爱岗	敬业
爱民如子	爱国
讨厌	厌恶
嫌弃	厌弃
厌倦	倦
厌世	厌战
恨	怨
仇视	仇恨
怀恨	记恨
愤恨	痛恨
责怪	怪罪
埋怨	抱怨
自咎	引咎
抱屈	抱委屈
尊敬	崇敬
敬仰	景仰
崇尚	崇
相敬如宾	举案齐眉
令人钦佩	可敬
尊师	尊老爱幼
佩服	敬佩
信服	服气
认输	服输
不服	要强
羡慕	慕
妒忌	忌妒
相信	凭信
确信	坚信
轻信	听信
当真	认真
自信	满怀信心
信仰	信奉
怀疑	狐疑
将信将疑	半信半疑
信任	相信
赞成	赞同
同意	认可
拥护	拥
拥军	拥军优属
反对	不敢苟同
忍耐	忍
克制	抑制
约束	收束
禁不住	撑不住
可惜	惋惜
舍得	不惜
爱惜	珍惜
吝惜	吝
怜悯	可怜
忍心	忍
体谅	谅解
推己及人	将心比心
原谅	见谅
宽恕	宽饶
关怀	关心
管闲事	多管闲事
担心	操心
放心	想得开
注意	留意
权衡	衡量
计较	斤斤计较
重视	珍视
保重	珍重
并重	并列
漠视	无视
鄙视	蔑视
置之不理	恝置
不置可否	听其自然
闲置	弃置
丢手	甩手
观望	旁观
顾及	照顾
顾不上	顾不得
理睬	理会
后悔	懊悔
悔改	改悔
后悔莫及	悔之晚矣
翻悔	反悔
反省	内省
无悔	无悔无怨
愿意	情愿
自愿	志愿
不甘	不甘心
无意	无心
敢	敢于
能够	能
善于	长于
不能	不许
决不会	不会
可以	得以
不可	不得
能否	可不可以
应该	应当
必须	务须
无须	毋庸
何须	何必
值得	犯得着
不值	不足
革命	变革
起义	首义
暴动	起事
锄奸	除暴安良
推翻	打倒
解放	翻身
斗争	争斗
斗法	钩心斗角
内乱	内讧
百花争艳	争奇斗艳
抗议	反抗
上台	登台
即位	登基
继位	承袭
称帝	称孤道寡
当家做主	当家
统治	秉国
称霸	独霸
称雄	割据
下台	下野
退位	让位
改革	改造
变法	维新
救国	救亡
闭关自守	闭关锁国
镇压	弹压
镇反	肃反
讨伐	征伐
平叛	平定
篡夺	攘夺
篡位	问鼎
颠覆	倾覆
复辟	变天
叛变	反叛
叛卖	出卖
通敌	私通
投敌	卖身投靠
招兵	征兵
抽丁	抽壮丁
装备	配备
备战	秣马厉兵
誓师	动员
检阅	阅兵
作战	打仗
接火	接触
开战	开仗
挑战	求战
应战	应敌
奋战	血战
激战	酣战
决战	决一死战
会战	大会战
转战	南征北战
起兵	动兵
同室操戈	火并
混战	群雄逐鹿
游击	打游击
好战	穷兵黩武
登岸	上岸
急行军	强行军
督战	督军
进攻	攻击
围攻	围击
夹攻	夹击
冲击	冲锋
追击	穷追猛打
抵抗	抵御
招架不住	不可抗力
回击	还击
保卫	捍卫
防守	防御
布防	设防
调防	换防
戍边	边防
警卫	警备
驻扎	屯扎
扎营	宿营
站岗	放哨
巡逻	巡查
射击	发射
开枪	打枪
开炮	放炮
还击	回击
空袭	轰炸
爆破	炸
刺杀	拼刺刀
扫雷	排雷
埋伏	打埋伏
袭击	侵袭
闪击	突击
邀击	拦击
抄袭	兜抄
偷营	偷袭
引敌他顾	调虎离山
接应	策应
掩护	打掩护
牵制	牵
侦察	侦探
包围	围困
突围	杀出重围
侵略	侵犯
并吞	吞并
骚扰	扰乱
攻占	抢占
占据	占
收复	克复
击败	打败
击退	退
歼灭	剿灭
围歼	聚歼
摧毁	击毁
撤兵	收兵
俘虏	生擒
缴获	收获
投降	归降
请降	乞降
佯降	诈降
割地	割让
归顺	归附
招安	招抚
大败	溃
治理	经纬
治世	治国
办理	办
经办	承办
包办	一手包办
代办	代理
筹办	筹划
处理	料理
清理	踢蹬
密封	封
管理	经营
保管	管理
综合治理	综治
经营	经纪
国营	国立
私营	私立
苦心经营	惨淡经营
营业	运营
主营	专营
自主经营	自营
安置	安顿
部署	布局
调动	调
调剂	调节
调拨	划拨
调遣	调派
整顿	整饬
整编	改编
派遣	指派
分派	分发
支使	支派
指名	点名
建立	成立
立国	开国
建都	奠都
立宪	立法
立户	立业
架起	搭设
合办	协办
设立	设置
开辟	辟
创立	开创
初创	草创
首创	创始
独创	自我作古
创出	创下
命名	定名
撤销	取消
废止	废除
免除	罢免
解散	遣散
一风吹	一笔勾销
收	接收
发	颁发
发放	发给
散发	分发
颁证	发证
请假	告假
主持	主管
指挥	挥
统率	统领
执掌	掌握
管辖	统辖
控制	统制
把持	垄断
召集	招集
宣布	发布
发榜	出榜
下令	命令
责令	责成
勒令	强令
令行禁止	言出法随
宣传	宣扬
发动	鼓动
提倡	倡议
号召	召唤
唤回	召回
响应	应
呼叫	呼唤
建议	提议
讨论	议论
决定	定规
定局	拍板
规定	确定
肯定	确认
否定	否决
制订	制定
拟订	拟定
登记	注册
签到	报到
报失	挂失
申请	报名
报考	投考
报告	汇报
交差	交卷
虚报	浮报
回报	回话
上书	奏
签字	签名
画押	签押
盖章	打印
批阅	圈阅
批示	批复
签注	签证
批准	照准
禁止	取缔
禁而不止	屡禁不止
解禁	弛禁
调查	考察
侦查	侦探
察明	查清
审查	审察
审定	核准
过目	寓目
自审	自查
初查	收审
检查	稽查
盘查	盘问
联检	联查
监督	督察
监视	监
监考	监场
督促	钉
查点	清点
点名	点卯
评议	评判
评论	评说
考核	考绩
奖励	嘉奖
发奖	授奖
金质奖	头彩
奖惩	奖罚
表扬	褒扬
处罚	处分
开除	革除
检讨	检查
选举	推选
选拔	甄拔
提拔	提升
聘请	聘任
敦聘	礼聘
招聘	征聘
征募	招募
任命	任
委任	委派
封爵	封
册立	册封
任用	起用
荫袭	荫
撤职	革职
罢官	罢黜
贬谪	贬斥
雇用	雇佣
解雇	解聘
下任	卸任
就职	到职
接替	接手
交卸	移交
办公	办公室
办事	做事
出差	出勤
值班	当班
守夜	值夜
巡夜	查夜
出巡	巡幸
清道	喝道
建筑	建造
动土	动工
营造	营建
打夯	夯
改建	改造
翻修	翻盖
基本建设	基建
架设	架
铺设	敷设
养护	护养
放置	码放
安装	装置
装配	配
组建	组装
粉刷	抹灰
油漆	漆
装饰	装点
制造	制作
酿造	酿
仿造	仿制
再生	还魂
造假	掺假
修理	整修
切削	铣
切割	割
焊接	焊
电焊	电弧焊接
铆接	铆
冶炼	冶金
锻造	打铁
铸造	浇筑
轧钢	轧
冲压	冲
拉延	拉制
镀	鋈
熔化	熔
淬火	蘸火
锢露	锢
提纯	提炼
裂化	裂解
镶金	错金
漂白	漂
染色	染
印染	印花
编织	编制
缫丝	抽丝
排字	排版
付排	发排
印刷	印
装订	订
出版	问世
发行	刊行
再版	重版
勘察	勘查
勘探	钻探
测量	测
开矿	采矿
疏浚	疏通
治水	治理
防洪	防汛
灌溉	浇灌
开山	劈山
垦荒	垦殖
屯垦	屯田
开拓	开辟
种地	种田
耕作	耕耘
平地	整地
破土	垦
耕	犁
耦耕	秋耕
深耕细作	精耕细作
刀耕火种	火种刀耕
间作	间种
套作	套种
连作	重茬
轮作	轮种
春化	催青
播种	下种
点播	点种
耧播	耩
种植	栽种
栽培	培植
移栽	定植
扦插	插条
培土	耔
嫁接	枝接
整枝	打杈
施肥	粪
条施	沟施
锄草	除草
收割	收
打场	脱粒
打猎	狩猎
捕鱼	打鱼
钓鱼	垂钓
撒网	网
畜牧	牧畜
放牧	牧
饲养	畜养
肥育	育肥
养殖	繁育
配种	配
阉割	去势
屠宰	宰杀
出产	生产
贸易	交易
通商	流通
输出	出口
输入	进口
投资	入股
集资	合股
融资	筹融资
招股	募股
招揽	招徕
标价	明码
讲价	议价
要价	讨价
抬价	哄抬物价
压价	杀价
成交	拍板
买	购
收购	收买
订购	定购
邮购	函购
抓药	打药
卖	售
倒卖	倒腾
销售	销行
兜销	兜售
经售	经销
专卖	榷
抛售	抛
批发	发行
零售	零卖
寄卖	寄售
拍卖	甩卖
出倒	招盘
出让	转让
变卖	变
脱手	出脱
粜	出粜
炒买炒卖	炒卖
卖掉	卖出
走俏	紧俏
出租	租
转租	包租
租用	租借
营利	赚
渔利	牟利
分红	分配
翻本	捞本
兑换	换钱
兑现	兑付
放债	放款
借债	举债
挪借	挪用
摘借	摘
借支	透支
降息	减利
欠债	欠帐
欠	该
赊欠	赊
讨债	索债
还债	折帐
典当	典
抵押	押
抵账	抵债
赔偿	赔
赔款	赔帐
理赔	索赔
赎回	赎
征收	征
收费	收款
交纳	缴纳
交款	缴费
缴税	交税
支付	支出
付帐	会帐
垫付	垫
付清	付讫
两讫	收讫
催讨	追缴
划价	计费
偷税	偷逃税
拨款	拨付
记帐	入帐
盘帐	查帐
销帐	核销
报帐	报销
盘点	盘存
积累	累积
积储	积蓄
积久	日积月累
花费	花
耗费	消耗
白费	枉费
浪费	旷费
挥霍	糟蹋
节省	节约
挤出	抽出
足够	十足
相抵	抵消
剩余	下剩
结存	留存
亏欠	亏空
亏损	亏耗
亏本	亏蚀
缺少	短少
不足	欠缺
遗漏	脱漏
合计	共计
驾驶	驾
驾车	驱车
驾御	赶
搭客	拉脚
搭乘	乘
行驶	驶
疾驶	奔驶
航行	航
航空	宇航
上水	上行
下水	下行
巡航	巡弋
划船	摇船
旅行	行旅
出行	出外
远行	出远门
跋涉	跋山涉水
舟车	车马
同路	同行
出境	离境
赶路	趱行
抄道	抄近路
绕道	绕远儿
带路	引路
引航	引水
领航	导航
搬运	搬
运输	输
河运	漕运
驳运	驳
流放	放
押运	押送
装载	装
经过	经由
越过	穿过
渡河	摆渡
拐弯	转弯
急弯	急转弯
离开	撤离
滚蛋	滚开
背井离乡	离乡背井
返回	归来
返乡	还乡
荣归	衣锦还乡
回家	还家
折回	转回
复归	复返
到达	抵达
停靠	停
停泊	下碇
教育	教导
谆谆教导	循循善诱
安居而乐教	安居乐教
传授	传
示范	示例
开导	诱导
发蒙	启蒙
指点	指
唤醒	唤起
引导	指引
化装	扮装
卸妆	卸装
修养	修身
摄影	留影
调焦	测距
曝光	暴光
冲洗	洗印
录音	灌音
放映	上映
广播	播送
管教	教养
教训	训
警告	警戒
讲课	授课
讲习	传习
训练	训
练习	操练
练嗓子	吊嗓子
演武	练功
锻炼	锤炼
练出	练就
强身健魄	强身健体
培养	培植
育人	教书育人
试验	实验
考试	考
大考	期考
应试	应考
春试	会试
发射	发出
学习	念书
复习	温习
自学	自习
实习	见习
半工半读	勤工俭学
取长补短	用长避短
囫囵吞枣	生吞活剥
重读	复读
从师	投师
模仿	效仿
上行下效	上梁不正下梁歪
留学	留洋
逃学	旷课
阅读	阅
默读	默诵
读报	看报
查阅	查看
朗读	宣读
吟咏	咏叹
唱酬	酬和
诗朗诵	吟诗
背诵	记诵
挥笔	挥毫
大写	小写
填	填写
代笔	捉刀
手书	亲笔
抄写	誊写
临摹	摹写
默写	默
涂抹	涂鸦
划	扛
提行	抬头
记录	笔录
记	笔记
手记	手写
摘记	摘录
附笔	附言
解释	解说
注释	诠注
引证	引用
用典	用事
参阅	参见
介绍	说明
标注	标明
标点	圈点
评点	批
分析	辨析
推敲	琢磨
去粗取精	去伪存真
研究	钻研
探究	探索
追根	追溯
抠	抠字眼儿
考证	考据
分类	分门别类
归纳	归结
总结	小结
推理	推导
类推	类比
写作	著作
起草	草
布局	搭架子
执笔	动笔
完稿	杀青
编造	臆造
堆砌	雕砌
谱曲	作曲
作诗	赋诗
合著	合写
编成	作出
翻译	翻
音译	译音
编辑	编纂
编录	辑录
补遗	补正
校对	校
校订	校勘
润色	润饰
修改	改动
更正	修正
指正	雅正
删改	删节
删除	剔除
改错	纠错
修订	审订
订正	勘误
绘画	描画
画像	写真
勾	勾勒
着色	上色
渲	渲染
制图	绘图
雕刻	镌刻
雕花	镂花
医治	医
诊	听诊
诊断	确诊
诊脉	号脉
行医	救死扶伤
就医	就诊
求医	求治
救治	救护
消毒	杀菌
刮痧	揪痧
修补	修复
消肿	消炎
打针	注射
扎针	针刺
补液	输液
种痘	种牛痘
开刀	动手术
配药	配方
下药	投药
接生	接产
打胎	刮宫
演出	表演
配戏	跑龙套
会演	汇演
预演	试演
武打	短打
打诨	插科打诨
出台	出场
下台	下场
排演	排戏
扮演	饰演
唱歌	唱
高唱	高歌
悲歌	长歌当哭
哼	哼唧
对唱	对歌
帮腔	和
变调	移调
跳舞	舞蹈
歌舞	轻歌曼舞
演奏	奏乐
吹奏	吹
弹奏	弹
拍板	击节
发球	开球
拦网	封网
踢球	蹴鞠
打拳	练拳
溜冰	滑冰
游泳	游水
蝶泳	海豚泳
下棋	着棋
将	将军
比赛	竞赛
赛马	跑马
争衡	夺标
奥林匹克	奥运会
争奇斗艳	争妍斗丽
见分晓	见雌雄
胜利	夺魁
蝉联	卫冕
交际	应酬
交往	来往
结交	相交
交好	通好
拉关系	拉交情
处世	做人
相处	相与
睦邻	友邻
凭借	借助
访问	拜访
登门	上门
回访	回拜
进见	晋见
朝见	觐见
探望	看望
省亲	探亲
走亲戚	串亲戚
串门子	走门串户
邀请	约请
邀集	约集
约定	说定
约稿	稿约
赴约	践约
守信	言而有信
算数	算
践诺	实践
失信	食言
失约	负约
翻脸	闹翻
迎接	迎迓
迎宾	夹道欢迎
会面	见面
陪伴	陪
做伴	作陪
接送	迎送
送别	送行
饯行	饯别
告别	告辞
等候	听候
少待	稍候
坐等	坐待
有待	有待于
驱逐	赶走
收留	收容
挽留	款留
招呼	打招呼
招待	接待
对待	对
宽待	优待
虐待	凌虐
对付	应付
过场	走过场
敷衍	应付
祝愿	祝
祝贺	庆贺
庆祝	庆
贺年	拜年
祝寿	拜寿
闹新房	暖房
请安	问安
写信	来信
投书	投送
复信	回信
汇款	邮汇
邮寄	付邮
投递	递送
拍电报	发报
打电话	挂电话
讲话	说话
吭声	吭气
耳语	私语
咕哝	咕唧
唠叨	叨唠
噜苏	赘言
炒冷饭	旧调重弹
瞎说	乱说
吞吐	吭哧
直言	和盘托出
倾诉	倾吐
诉说	陈诉
鼓舌	摇唇鼓舌
插话	插嘴
搭腔	搭话
说笑	耍笑
会话	对话
侈谈	唱高调
空谈	放空炮
话旧	叙旧
话别	叙别
交谈	叙谈
面谈	晤谈
泛泛而谈	浅说
恳谈	交心
畅谈	倾谈
漫谈	纵谈
断言	预言
说闲话	闲言闲语
冷言冷语	吹冷风
慷慨陈辞	侃侃而谈
一语道破	一语破的
总而言之	总之
欢歌笑语	欢声笑语
致词	致辞
谈天	聊天儿
神聊	说东道西
演讲	讲演
论述	论说
列举	罗列
叙述	叙说
陈述	陈说
详述	慷慨陈词
铺叙	铺陈
述说	称述
追述	追叙
记叙	记事
声称	宣称
描写	描绘
写实	写真
表示	示意
吹风	放风
志	道
暗示	丢眼色
表达	抒发
抒情	抒怀
阐明	阐发
表白	剖白
表露	吐露
发誓	盟誓
告诉	告知
禀告	禀
晓谕	晓示
转告	转达
预告	预报
告警	报警
告捷	报捷
通知	知照
透风	通风报信
嘱咐	叮嘱
介绍	引见
说合	撮合
说媒	做媒
搭桥	牵线搭桥
推荐	引荐
保荐	保举
自荐	毛遂自荐
露面	照面儿
出面	出名
代替	代表
替班	顶班
问	发问
查问	查询
盘问	细问
追问	诘问
反问	反诘
责问	诘问
质问	质疑
请示	请命
答	回答
对质	对簿
吹牛	说嘴
自夸	自诩
吹嘘	鼓吹
夸张	虚夸
说谎	扯谎
造谣	造谣惑众
放空气	放冷风
隐瞒	隐秘
掩盖	掩饰
打掩护	打埋伏
粉饰	矫饰
保密	秘
揭露	揭发
揭穿	说穿
责备	责怪
自责	自咎
苛责	求全责备
谴责	声讨
批评	开炮
批判	批
批驳	驳斥
抹杀	勾销
攻击	抨击
承认	确认
认错	认罪
否认	否定
抵赖	狡赖
过问	干预
介入	参与
打听	探听
摸清	探明
试探	试
请求	乞求
求助	求援
求饶	告饶
哀求	哀告
征求	征询
乞怜	摇尾乞怜
委托	付托
拜托	央托
讲情	说情
赠送	馈送
转送	转赠
送礼	送人情
回礼	还礼
赏赐	赏
赠答	投桃报李
捐献	捐
献	奉
进贡	朝贡
捐给	献给
交	提交
呈	上
面交	递交
转交	转送
付费	付钱
取	领取
借	借用
出借	借给
归还	发还
退还	退回
交换	互换
掉包	偷梁换柱
更换	更替
传递	传接
催促	催
抵偿	抵
感谢	感
酬谢	酬答
答谢	谢恩
报答	报偿
道歉	致歉
请罪	负荆请罪
谦让	礼让
让座	让位
让路	让道
让步	退让
迁就	将就
协商	相商
谈判	交涉
会商	会谈
接洽	面洽
和平谈判	和谈
订约	缔约
答应	应
允许	容许
拒绝	回绝
谢绝	辞谢
推托	推
搪塞	搪
推卸	推委
委罪	归咎
鼓励	勉励
激励	激扬
劝告	相劝
规谏	进言
游说	说
劝阻	劝止
安慰	劝慰
慰劳	慰问
帮助	扶助
互助	互济
周济	接济
救急	雪中送炭
帮衬	补助
赈济	赈
行善	行好
成全	周全
辅佐	佐
助威	助战
支持	帮腔
打下手	跑腿
拯救	救
救命	救生
救火	扑救
救活	活命
救应	接应
献计	献策
照顾	照拂
服侍	伺候
护理	看护
保护	掩护
保驾	保镖
护身	防身
收养	认领
领养	抱养
抚养	拉扯
保育	抚育
赡养	奉养
遵守	信守
遵命	奉命
听从	顺从
违背	违反
违犯	触犯
抗拒	抗
称赞	夸赞
盛赞	叹为观止
过奖	过誉
耻笑	取笑
讥讽	嘲讽
丑化	搞臭
诬蔑	污蔑
反咬一口	倒打一耙
争论	争议
辩论	辩
分辨	分说
狡辩	强辩
议论	讨论
公议	公论
妄下雌黄	信口雌黄
街谈巷议	议论纷纷
大放厥词	厥词
骂	詈
责骂	叱骂
痛骂	臭骂
咒骂	诅咒
怒斥	叱喝
呵责	呵斥
辱骂	诟骂
对骂	骂架
争吵	吵
顶嘴	还嘴
顶撞	顶
吵闹	闹
闹意见	闹别扭
作对	顶牛儿
殴打	打
打架	对打
打伤	击伤
调解	排解
拉架	劝架
屈服	慑服
降伏	收服
说服	以理服人
讲和	媾和
谄媚	献媚
笼络	牢笼
攀附	攀缘
迎合	投其所好
包庇	庇护
偏袒	偏护
放任	任凭
姑息迁就	牵就
纵容	纵令
姑息	宽纵
自暴自弃	破罐破摔
欺骗	蒙骗
耍花招	耍花腔
欺瞒	蒙蔽
迷惑	糊弄
偷梁换柱	偷天换日
自欺欺人	掩耳盗铃
骗人	坑人
捣鬼	搞鬼
得罪	冒犯
激怒	触怒
纠缠	软磨
抓辫子	揪辫子
打搅	搅
麻烦	烦劳
阻拦	阻挠
堵嘴	免开尊口
挡路	阻路
拉后腿	扯后腿
拆台	挖墙脚
耍赖	撒赖
刁难	放刁
挑剔	挑眼
引逗	挑逗
戏弄	捉弄
开玩笑	调笑
逗笑儿	逗乐儿
摆布	摆弄
怂恿	唆使
指使	主使
强迫	逼迫
勉强	强人所难
挟制	强制
恐吓	恫吓
威胁	威慑
核威胁	核威慑
引诱	勾引
欺负	欺侮
蹂躏	践踏
侮辱	污辱
排挤	排斥
陷害	谗害
暗害	暗算
下药	毒
乘人之危	趁火打劫
危害	害处
勾结	勾搭
帮凶	助桀为虐
挑拨	挑唆
破坏	败坏
坏事	误事
侵害	侵蚀
毒害	流毒
腐蚀	销蚀
报仇	复仇
公报私仇	官报私仇
报复	复
回报	报
雪冤	申雪
结伴	搭伴
结伙	为伍
拜盟	拜把子
结盟	同盟
断交	绝交
散伙	拆伙
生活	过活
谋生	营生
居住	住
群居	聚居
小住	暂住
寄居	旅居
定居	安家
隐居	蛰居
住宿	歇宿
露宿	露营
家居	闲居
居无定所	东奔西跑
风俗	乡规民约
停留	稽留
迁移	迁徙
迁居	移居
消磨	打发
度过	度
捱	熬
虚度	蹉跎
经历	经验
亲历	躬逢
做寿	做生日
迎春	喜迎春
过节	逢年过节
独立	自立
自力更生	自食其力
依附	仰人鼻息
受制于人	受人牵制
随大溜	随群
混日子	得过且过
吃闲饭	吃现成饭
依托	依赖
流浪	流荡
流亡	逃亡
投靠	投奔
奔波	奔走
走江湖	跑江湖
操劳	累
抽空	偷空
发奋	奋发
自励	自勉
争先创优	评先创优
荒废	荒疏
兴	振兴
偷懒	躲懒
避难就易	避重就轻
偷生	偷安
过继	继嗣
承继	继承
工作	干活儿
上工	上班
共事	同事
单干	唱独脚戏
从业	在业
劳动	劳
突击	赶任务
怠工	磨洋工
打夜作	开夜车
跑腿儿	跑龙套
致富	脱贫致富
做	作
办好	做好
办成	办到
施展	施
露一手	牛刀小试
合作	协作
尝试	试行
试工	试办
抱佛脚	临时抱佛脚
放马后炮	贼去关门
赶浪头	赶时髦
留后路	留后手
留后患	养虎遗患
效劳	效力
造福	谋福利
发扬	恢弘
增光	光大
增色	生色
玷污	玷辱
补救	弥补
挣扎	挣命
冒险	虎口拔牙
拼命	玩儿命
守节	节烈
守身	守身如玉
变节	失节
从事	务
厕身	侧身
参加	加入
入席	就席
混进	混入
脱离	脱
退伍	退役
解脱	摆脱
脱钩	脱节
出席	列席
缺席	不到
谋事	找事
做工	做活儿
扛长活	扛活
打短工	打短儿
务农	种田
经商	做生意
跑码头	跑单帮
任教	执教
行医	从医
参军	从军
投笔从戎	弃文就武
出家	削发
入行	出道
做官	从政
辞职	退职
离职	去职
引退	隐退
退休	离休
担负	担当
承揽	兜揽
担任	充任
胜任	独当一面
任职	供职
连任	连选连任
兼职	兼任
采集	收集
搜罗	收罗
挑选	拣选
选材	甄拔
择友	择交
抽样	取样
取长补短	截长补短
观察	观测
综观	通观
展望	瞻望
看破	看穿
比较	比拟
对比	对照
区分	区别
辨别	辨明
判断	断定
开门揖盗	引狼入室
使用	应用
自用	私用
享用	受用
零用	零花
用于	用来
沿用	套用
因循	因袭
照搬	生搬硬套
借鉴	引为鉴戒
称	过秤
量	计量
丈量	丈
计算	划算
核算	核计
换算	折算
掐算	能掐会算
运算	演算
合并	合
凑合	拼凑
分开	划分
平分	均分
中分	平分秋色
分摊	分担
分成	分为
出钱	出资
筹集	凑份子
起床	起身
睡觉	睡
小睡	打盹儿
午睡	歇晌
休息	休憩
歇工	休工
乘凉	纳凉
疗养	将养
调养	保养
补养	滋补
理发	剃头
梳头	梳理
烫发	烫头
刮脸	修面
打扮	装扮
梳妆	梳洗
描眉	画眉
整理	整
归拢	归着
整装	治装
料理	张罗
准备	预备
筹备	筹划
携带	随带
拉家带口	拖家带口
跟随	尾随
赶集	赶场
外出	出外
出走	出奔
逃跑	逃走
溃逃	溃散
卷逃	席卷而逃
逃窜	窜逃
溜走	溜号
逃命	逃生
逃离	逃出
躲藏	隐藏
躲避	退避
跟踪	盯梢
追踪	蹑踪
寻找	找寻
翻箱倒柜	倾箱倒箧
储藏	贮藏
坚壁	坚壁清野
储备	贮备
储存	贮存
保存	封存
归档	存档
库藏	库存
储蓄	储
缝纫	缝
绷	缉
缝补	修补
刺绣	绣花
滚边	沿边儿
纫针	穿针
晒	晾
熨	烫
点灯	掌灯
烧火	点火
点燃	燃点
烧化	焚化
加热	烧
烘	焙
取暖	暖
烧火	着火
烹饪	烹调
掌勺儿	掌勺
做饭	起火
烹茶	泡茶
炒	煎
炸	氽
烤	炕
煮	烧
熬	馇
氽	炝
蒸	烀
拔丝	拉丝
回锅	回炉
品尝	品味
尝新	尝鲜
点饥	点心
充饥	果腹
用餐	就餐
下饭	佐餐
吃素	素餐
吃荤	肉食
偏食	挑食
喂食	哺
哺乳	喂奶
会餐	聚餐
设宴	宴请
做东	作东
接风	洗尘
敬酒	劝酒
猜拳	划拳
展览	展出
欣赏	玩赏
游戏	游玩
捉迷藏	藏猫儿
猜谜儿	破谜儿
游览	游历
郊游	踏青
消遣	清闲
游荡	游逛
行乐	取乐
抽签	抓阄儿
恋爱	相恋
钟情	一见钟情
追求	求偶
求婚	求亲
调情	吊膀子
偷情	偷香窃玉
约会	幽会
订婚	定婚
许配	许
结婚	婚
新婚	新婚燕尔
联姻	缔姻
娶	娶亲
续弦	纳妾
嫁	出嫁
改嫁	转嫁
再嫁	再婚
入赘	上门
离婚	离异
退婚	退亲
自杀	自尽
自刎	抹脖子
上吊	吊死
投河	投井
治丧	丧葬
吊丧	吊孝
大殓	装殓
出殡	殡葬
送殡	送丧
安葬	埋葬
火葬	火化
海葬	水葬
陪葬	殉葬
戴孝	穿孝
扫墓	上坟
瞻仰	参谒
祭祀	祭
祭奠	祭
生事	闹事
蠢动	蠢蠢欲动
挑衅	寻衅
胡闹	胡来
肆行	胡作非为
捏造	编造
冒充	假冒
冒名	假托
沽名钓誉	欺世盗名
炫耀	夸耀
邀功	邀功请赏
摆阔	摆摊子
摆门面	摆样子
撑场面	撑门面
摆架子	拿架子
逞能	逞强
卖乖	卖弄聪明
班门弄斧	布鼓雷门
逞性	任性
感情用事	意气用事
拾荒	捡破烂儿
乞讨	讨乞
上来	上去
蜂拥而上	一哄而上
下去	下来
来	来到
莅临	降临
接踵而来	源源而来
去	过去
开往	开赴
一怒而去	拂袖而去
来去	来回
出	出来
进	进入
流入	流
升堂入室	登堂入室
出入	进出
进出境	入出境
弄错	失误
失言	失口
鲁鱼亥豕	鲁鱼帝虎
点金成铁	画蛇添足
失职	渎职
犯规	犯禁
混淆	搅混
澄清	弄清
颠倒	颠倒是非
反客为主	喧宾夺主
篡改	歪曲
改正	纠正
纠偏	补偏救弊
改过	悔过
真假	真伪
前进	迈进
乘风破浪	长风破浪
阔步前进	昂首阔步
并进	齐头并进
后退	退
追赶	追逐
祷告	祈祷
礼拜	顶礼膜拜
跪拜	礼拜
祝福	赐福
朝觐	朝圣
拜佛	敬奉
烧香	焚香
斋戒	吃斋
念经	诵经
修行	修道
传教	传道
募化	化缘
布施	施舍
炼丹	点化
测字	拆字
看相	相面
圆梦	占梦
占卜	占
占卦	算卦
打醮	醮
保佑	庇佑
检举	揭发
弹劾	参
控告	告状
上告	上诉
喊冤	叫屈
诬告	诬
诉讼	词讼
自首	投案
招认	供认
招供	自供
搜查	抄家
搜身	抄身
拘留	羁留
囚禁	监禁
软禁	幽禁
劳改	劳动改造
逮捕	拘捕
拿获	捕获
押送	解送
释放	开释
审讯	审问
复审	再审
审理	审判
提审	传讯
开庭	过堂
刑讯	拷问
判决	裁判
判罪	论罪
定案	定责
量刑	处刑
惩办	法办
严惩	重办
惩戒	惩前毖后
上刑	动刑
凌迟	剐
车裂	五马分尸
支解	磔
灭族	夷族
没收	充公
查封	封闭
剥夺	褫夺
游街	示众
充军	发配
偿命	抵命
处决	正法
枪毙	枪决
斩首	杀头
赦免	大赦
免罪	免刑
违法	犯法
枉法	贪赃枉法
知法犯法	执法犯法
放火	纵火
绑架	绑票
持机	劫机
抢劫	打劫
路劫	断路
洗劫	洗劫一空
趁火打劫	趁人之危
盗窃	偷窃
鼠窃狗偷	偷鸡摸狗
窝赃	窝藏
分赃	坐地分赃
杀死	杀
杀害	凶杀
活埋	坑
下毒	放毒
自相残杀	自相残害
暗杀	刺杀
屠杀	杀戮
狎妓	嫖妓
卖淫	卖身
通奸	私通
奸污	奸淫
调戏	玩弄
赌博	赌钱
压	压宝
抽头	打头
钻营	钻谋
贿赂	行贿
受贿	纳贿
舞弊	作弊
徇私	徇情
剽窃	剽取
侵吞	吞没
克扣	揩油
敲诈	讹
打秋风	秋风
拐骗	拐带
诈骗	诈
剥削	盘剥
搜刮	搜括
投机	投机倒把
浑水摸鱼	捞
囤积	囤
走私	走漏
天亮	发亮
日上三竿	晴好
天暗	天黑
夕阳西下	日薄西山
晴	晴朗
风和日暖	风和日丽
放晴	霁
阴	阴暗
刮风	起风
拂面	扑面
萧萧	萧瑟
狂风怒号	飞砂走石
下雨	降雨
滂沱	霈
风狂雨骤	暴风骤雨
风雨交加	风雨如磐
雨天	下雨天
下雪	大雪纷飞
风雪交加	风雪
降霜	霜降
打闪	闪电
打雷	霹雳
起雾	雾蒙蒙
冒烟	浓烟滚滚
起浪	波涛汹涌
照射	投射
照亮	照明
光照	普照
反射	反照
辐照	辐射
交相辉映	晖映
照见	映出
折光	折射
发光	发亮
闪光	闪亮
金光闪闪	金闪闪
作响	响
轰	轰鸣
爆炸	爆裂
炸毁	炸裂
核爆炸	核爆
燃烧	焚烧
烧毁	焚毁
焦	燎
沸腾	开锅
蒸发	挥发
溶解	溶化
融化	溶化
冷却	冷
结冰	冻结
解冻	化冻
腐烂	腐败
发霉	霉
变质	馊
生锈	锈
褪色	落色
生育	生产
孪生	双生
足月	待产
分娩	分身
坐月子	坐蓐
流产	小产
生于	出生于
诞生	出生
生长	见长
成长	长进
出挑	出脱
长成	长大
繁殖	生殖
下	生
孵	抱
发胖	发福
活	生
回生	生还
死	亡
仙逝	千古
牺牲	舍身
横死	凶死
升天	坐化
夭折	夭亡
半死	濒死
醒	睡醒
入睡	入梦
沉睡	熟睡
休眠	眠
瞌睡	打盹
失眠	辗转反侧
饱	打饱嗝儿
饿	饥
渴	干
馋	嘴馋
醉	醺
酩酊	醉醺醺
打嗝儿	嗳气
喷嚏	嚏喷
打呵欠	打哈欠
大便	大解
便秘	下泄
小便	小解
尿床	尿炕
癃	闭
解手	净手
出汗	流汗
盗汗	出冷汗
行经	来潮
性交	交媾
交配	交尾
遗精	梦遗
怀孕	怀胎
受孕	受胎
生病	害病
不适	不快
犯病	发病
欠安	不安
病重	病笃
病危	危笃
垂死	垂危
受伤	负伤
遍体鳞伤	体无完肤
扭	蹩
烧伤	灼伤
伤亡	死伤
杀伤	刺伤
病愈	痊愈
好转	见好
收口	合口
复活	还魂
痒	痒痒
酸	酸软
痛	疼
心绞痛	狭心症
肿	膀
胀	发胀
食积	存食
消化	克
咳	咳嗽
吐	呕吐
孕吐	害喜
吐血	呕血
泻	腹泻
着凉	受凉
受暑	受热
发烧	发热
高烧	高热
头昏	昏
昏沉沉	昏昏沉沉
眼花	昏花
休克	虚脱
昏迷	昏倒
谵妄	说胡话
抽搐	抽搦
麻木	发麻
瘫痪	风瘫
单瘫	下痿
发疯	发狂
心悸	心跳
贫血	血亏
梗塞	栓塞
肠梗阻	肠阻塞
出血	衄
化脓	溃烂
哑	喑
聋	背
瞎	失明
口吃	结巴
驼	驼背
跛	瘸
开花	开放
结果	结实
凋谢	萎谢
吐穗	抽穗
受粉	受精
发芽	抽芽
成熟	熟
笑	乐
大笑	绝倒
微笑	莞尔
发笑	失笑
苦笑	干笑
暗笑	窃笑
奸笑	皮笑肉不笑
谄笑	胁肩谄笑
憨笑	傻笑
笑哈哈	笑呵呵
嬉皮笑脸	嘻嘻哈哈
含笑	笑容满面
哭	啼哭
号	号哭
泣	哭泣
流泪	挥泪
泪如泉涌	泪如雨下
含泪	泪汪汪
害臊	害羞
红脸	脸红
没羞	不害羞
卖俏	搔头弄姿
传情	眉目传情
撒娇	发嗲
娇滴滴	嗲声嗲气
叹气	叹息
长叹	浩叹
悲叹	哀叹
慨叹	喟叹
发呆	发愣
沉默	默然
不做声	闷头儿
振奋	振作
激发	鼓
激昂	激扬
疲倦	疲劳
风尘仆仆	仆仆风尘
懒散	恹恹
颓唐	萎靡不振
板脸	绷脸
瞪眼	怒目
喘息	气短
气喘	哮喘
屏气	屏息
假装	伪装
做作	扭捏
装傻	装疯卖傻
假死	佯死
翘	跷
悬	荡
垂	下垂
披	披散
凸起	隆起
凹陷	陷
裸露	赤露
裸体	赤裸裸
赤膊	赤背
赤脚	赤足
遮盖	掩盖
遮挡	遮蔽
笼罩	笼
伸	引
展	伸展
直	挺直
挺	腆
缩	收缩
蜷缩	挛缩
伸缩	舒卷
张合	翕张
落下	落
倒塌	坍塌
塌方	坍方
天塌地陷	天坍地陷
损坏	弄坏
裂开	裂
爆裂	迸裂
折断	断裂
耸立	矗立
停放	放置
寄放	存放
悬挂	吊
颠倒	倒
陈列	陈放
布置	陈设
排列	排
列为	名列
分布	散布
堆积	堆
淤积	沉积
散落	洒
浇	淋
溅	迸
喷	喷射
溢	漫
滴	沥
泡	浸
淹	淹没
沉	没
陷	下陷
漂	浮
磁悬浮	磁浮
流	流动
奔泻	倾泻
潺潺	涓涓
翻腾	翻滚
飘	飘扬
移动	运动
滑动	滑行
等速运动	匀速运动
简谐运动	谐振
动弹	动作
跳动	扑腾
摇摆	摇晃
颤动	抖动
旋转	打转
运转	运行
盘旋	回旋
缭绕	旋绕
滚动	骨碌
掉转	扭转
转身	回身
弯转	弯
润泽	滋润
刺激	刺
撞	击
触	碰
着	巴
相遇	遇
狭路相逢	冤家路窄
巧遇	偶遇
重逢	久别重逢
错过	相左
摩擦	磨蹭
附着	黏附
畅通	通畅
通风	透风
阻塞	闭塞
卡	鲠
漏	透
漏水	渗水
漏风	透风
漏光	透光
漏气	透气
交界	分界
靠近	邻近
紧靠	紧贴
逼近	迫近
相距	距离
连绵	绵亘
相隔	分隔
围绕	环绕
包围	包
簇拥	拥
扭结	纠结
交叉	交
交错	纵横
混杂	搀杂
超重	过重
传导	传
传播	传布
流传	传
世传	传世
传说	相传
谣传	以讹传讹
流行	风行
成风	蔚然成风
相沿成习	约定俗成
连接	连
承	承接
联系	关联
组网	连网
纠缠	缠
积压	积
结合	组合
割裂	隔断
相持	对峙
鼎立	三足鼎立
生效	见效
失效	失灵
陪衬	烘衬
点缀	装点
定局	决定
未定	未决
已婚	成家
团结	合力
同心	齐心
和衷共济	同舟共济
求同克异	求同存异
合并	归并
一统天下	世界一统
三位一体	统一体
分裂	瓦解
分道扬镳	各行其是
离心离德	同床异梦
团聚	聚会
离别	分别
背井离乡	离乡背井
阔别	久别
永别	永诀
集合	聚合
聚齐	取齐
密集	麇集
纠集	纠合
云集	荟萃
分散	疏散
星散	风流云散
离散	天各一方
妻离子散	鸾飘凤泊
如鸟兽散	树倒猢狲散
占先	领先
为首	带头
争先	抢先
殿后	排尾
落	掉
命中	打中
进步	上进
奋进	跃进
渐进	循序渐进
并进	齐头并进
退步	落后
堕落	腐化
实行	推行
遵行	奉行
举行	召开
完成	完竣
脱稿	定稿
脱手	出手
实现	兑现
耽误	延误
拖延	延宕
期满	满
到期	到时
过期	逾期
来得及	赶得及
来不及	赶不及
禁得起	经得起
禁不起	禁不住
享福	纳福
吃苦	受苦
沾光	讨巧
占便宜	讨便宜
不劳而获	吃现成饭
受益匪浅	获益匪浅
互惠	互利
上当	受骗
吃亏	吃哑巴亏
走运	幸运
发财	发家
暴富	暴发
吉利	吉庆
倒霉	倒运
多灾多难	祸不单行
走投无路	走头无路
糟糕	坏
顺利	顺手
顺势	趁势
不利	周折
尴尬	狼狈
一筹莫展	束手无策
折磨	折腾
成名	扬名
声名鹊起	万世流芳
名誉扫地	扫地
出丑	丢丑
得志	得意
失意	落拓
失业	赋闲
丢官	免职
晋升	提升
扶摇直上	步步高升
降级	降职
升贬	升降
入选	中选
考中	考取
落第	名落孙山
受累	黑锅
受冤	蒙冤
背黑锅	李代桃僵
平反	昭雪
受奖	获奖
受罚	抵罪
被捕	落网
入狱	下狱
得宠	受宠
失宠	打入冷宫
扑空	吃闭门羹
碰壁	碰钉子
自作自受	自食其果
自讨苦吃	自找麻烦
适得其反	事与愿违
断子绝孙	断后
守寡	寡居
受灾	遭灾
闹灾荒	闹饥荒
旱	大旱
涝	洪涝
发水	山洪暴发
开口子	决口
受害	被害
遭殃	祸从天降
中弹	饮弹
遇刺	遇害
失火	起火
走电	跑电
触电	电
失窃	失盗
迷路	迷途
失踪	走失
不见踪影	无影无踪
遗失	丢失
闯祸	肇祸
召祸	招灾惹祸
遇救	获救
脱险	出险
胜利	取胜
战败	失败
惨败	大败
覆没	覆灭
被围	腹背受敌
沦陷	陷落
亡国	灭亡
胜败	高下
成功	成事
失败	挫败
垮台	坍台
倒闭	关闭
停业	歇业
打垮	搞垮
落空	泡汤
败露	东窗事发
暴露	露
显形	现形
大白	真相大白
泄漏	透漏
泄底	露底
失密	泄密
赚	得利
亏	蚀
损失	破财
亏空	亏欠
合算	上算
一举两得	一箭双雕
失算	划不来
涸泽而渔	竭泽而渔
失策	失计
失机	失时
丰收	丰产
歉收	欠产
开始	肇始
入手	着手
开工	兴工
破土	破土动工
开学	始业
开市	开拔
开动	开行
启程	起程
开车	发车
开航	起航
起飞	起航
起运	启运
开幕	揭幕
开演	开场
萌发	萌芽
起跑	开战
入春	入夏
结束	收束
罢休	罢手
作罢	罢了
散会	闭会
散场	散
毕业	卒业
下班	下工
收操	下操
下学	放学
售完	售罄
停止	终止
停滞	僵化
打烊	关门
熄灭	熄
停战	停火
住口	绝口
中断	中止
望而止步	驻足不前
进行	进展
双管齐下	齐头并进
继续	连续
流逝	蹉跎
寒来暑往	年复一年
重复	反复
循环	轮回
微循环	小循环
变化	变
变幻	无常
多变	反复无常
演变	演化
情随事迁	事过境迁
剧变	突变
渐变	潜移默化
质变	变质
变脸	变色
变味	霉变
变样	走样
成为	变成
欧化	西化
改变	变更
改换	更换
轮换	替换
交换	鸟枪换炮
改天换地	移风易俗
改弦更张	改弦易辙
改元	改朝换代
改行	跳行
改名	化名
改口	改嘴
转调	变调
转车	换车
扩大	壮大
放大	放
膨胀	膨大
蔓延	滋蔓
伸长	伸
延长	延伸
延年益寿	益寿
收缩	抽缩
缩小	压缩
缩水	抽水
浸湿	湿
增多	增加
增长	丰富
外加	附加
递增	递加
激增	猛增
倍增	加倍
增值	升值
添油加醋	添枝加叶
添补	增补
补遗	拾遗
弥补	弥缝
减少	减去
裁	淘汰
减半	折半
减员	裁员
裁军	精兵简政
骤减	剧减
优胜劣汰	选优淘劣
上升	升高
腾空	凌空
提高	增高
涨	上涨
涨潮	来潮
跃升	跃居
下降	降落
落潮	退潮
降价	减价
贬值	毛
升降	起落
提前	提早
推迟	延迟
加快	加速
放慢	减速
巩固	固
安定	安
增强	加强
加剧	加深
强国	兴国
削弱	减弱
冲淡	和缓
抓紧	赶紧
放松	松劲
好转	改善
出头	转运
转危为安	化险为夷
再生	更生
改进	改善
恶化	逆转
倾覆	大厦将倾
更新	翻新
面目一新	焕然一新
破旧立新	除旧布新
整旧如新	更型换代
复旧	复古
故态复萌	旧病复发
新生	新兴
兴起	起来
衰落	没落
衰败	颓败
世风日下	人心不古
是	为
就是	即
当做	当作
算	算作
比作	比方
叫做	叫作
自称	自封
意味	表示
影射	隐射
体现	反映
标志	标明
显示	显得
显见	足见
预示	预兆
证明	证实
起源	来源
取决	在于
归于	归属
属于	属
隶属	直属
所属	分属
相同	同
不约而同	殊途同归
众口一词	异口同声
同年	同岁
同班	同窗
相等	相当
匹敌	敌
等距离	等距
差不多	差不离
不同	各别
迥	悬殊
相反	相左
相似	相像
近似	相近
好似	似乎
活像	酷似
例如	比如
如下	如次
超过	超出
胜于	胜似
不及	不如
相形见绌	相形失色
不可企及	望尘莫及
适应	服
相配	般配
相辅相成	相辅而行
符合	吻合
相投	对
臭味相投	沆瀣一气
巧合	偶合
不合	不符
名不副实	言过其实
合不来	说不来
相对	对立
矛盾	抵触
自相矛盾	水火难容
需要	需
提供	供
供给	供
供应	支应
满足	饱
供求	供需
连贯	贯通
呼应	相应
易于	容易
存在	在
硕果仅存	鲁殿灵光
共存	共处
遗留	留
留	蓄
保持	维持
撑持	支持
处于	居于
位于	坐落
沉浸	沐浴
在于	在乎
陷于	陷入
适逢	适值
登载	刊载
有	拥有
集体所有	共有
还有	再有
占有	占据
容纳	包容
包括	囊括
充满	充塞
满怀	包藏
包含	含
显露	表露
呈现	显现
出现	现出
闪现	昙花一现
再现	重现
层出不穷	层见叠出
冒尖儿	脱颖而出
兀现	毕现
发生	产生
散发	发
突发	爆发
萌生	萌芽
发作	犯
消失	消散
告罄	罄尽
失去	失掉
丧失	丧
散失	逸
灭种	绝种
失传	绝版
恢复	还原
缓	缓气
摧毁	毁灭
解决	速决
克服	战胜
消灭	扑灭
荡涤	涤荡
灭绝	根绝
灭鼠	灭菌
消除	打消
洗雪	昭雪
戒除	戒
抛弃	摈弃
舍弃	放弃
葬送	断送
埋没	湮没
牵连	牵累
株连	卷入
涉及	关涉
相关	相干
无关	无干
影响	熏陶
触动	感动
动摇	摇撼
动人心魄	荡人心魄
带动	牵动
沾染	浸染
传染	传
引起	唤起
吸引	招引
导致	招致
使得	使
促使	驱使
催生	催产
给予	授予
寄予	寄托
加以	加
施加	强加
冠以	冠
推动	推进
激发	激起
提神	兴奋
妨碍	碍
杜绝	杜
限制	限量
局限	囿
约束	约
钳制	牵制
制止	抑止
支配	决定
超越	逾越
有利	利于
富民	利国利民
有害	损害
不利	不利于
无损	无害
防止	防备
避免	幸免
逃避	规避
避讳	忌讳
免得	省得
取得	得到
垂手而得	近水楼台先得月
失而复得	合浦还珠
荣获	荣膺
争取	争得
夺取	夺得
牟取	谋取
达到	达成
遂	称
挽回	扳回
遭受	蒙受
享受	消受
接受	领受
秉承	禀承
忍受	禁受
非常	异常
远	多
多么	多
最	顶
至多	最多
至少	最少
过分	过度
尽量	放量
殚思竭虑	殚思极虑
更加	更其
相当	一定
比较	较比
稍微	稍为
大多	多
完全	全然
全数	如数
精光	净尽
纯粹	纯
彻底	到底
半半拉拉	一半
都	净
一概	一律
只	单
只不过	左不过
不止	不仅
甚至	乃至
立刻	即刻
赶快	赶早
逐渐	逐步
姑且	暂且
临时	旋
预先	预
首先	率先
准时	正点
经常	时常
一再	再三
向来	素来
本来	原来
不断	不止
一口气	一股劲儿
一连	接连
源源不断	源源不绝
一直	一味
时刻	时时
每次	历次
动辄	动不动
已经	曾经
方才	刚才
新	初
正在	正
随即	随后
即将	行将
终于	终究
再	又
不再	不复
必然	决然
意料之中	不出所料
不可逆转	不可避免
十有八九	十之八九
管保	保管
未必	不一定
难保	难说
突然	忽然
偶然	偶尔
不料	不图
也许	或许
大概	大略
难道	莫非
不	非
不用	甭
没	没有
四顾无人	无人
竭力	极力
尽量	不择手段
任意	肆意
尽情	任情
胡乱	胡
特意	特地
故意	故
顺便	就便
随口	顺口
随手	顺手
顺路	顺脚
随身	身上
无心	无意
借故	托故
托病	称病
无故	无端
执意	硬是
只得	只好
共同	协同
分头	分别
独自	单独
互相	相互
从中	居中
亲自	亲身
亲手	手
挨次	顺次
轮流	轮番
交叉	穿插
迎头	当头
迎风	逆风
径自	径直
直接	径直
就地	当庭
间接	转弯抹角
恰巧	刚巧
幸亏	多亏
偏偏	偏巧
竟然	居然
几乎	差一点
险些	险乎
仍然	依然
尚且	还
索性	爽性
毕竟	究竟
简直	直
固然	固
反正	横竖
实在	委实
果然	果真
其实	实则
不免	未免
莫如	莫若
无怪	难怪
未尝	何尝
毋宁	无宁
宁可	宁肯
究竟	究
不妨	无妨
千万	万万
当然	自然
却	可
还	尚
也	亦
反而	相反
这样	这么
那样	那么
哪里	哪
怎样	怎么
为什么	什么原因
何不	盍
向	朝
对	迎
趋向	趋于
背	坐
在	于
从	自
到	至
等到	待到
以至	直至
沿	缘
跟	同
替	给
把	将
比	比较
对于	对
关于	有关
为	以
被	叫
以	用
由	归
依靠	倚靠
取给	吃
靠水吃水	靠海吃海
通过	经过
依照	按照
按理	按说
依法	有法可依
根据	依据
针对	对准
趁	乘
有机可乘	有隙可乘
和	同
连同	偕同
或者	或
并且	而且
况且	而况
但是	只是
虽然	虽说
即使	即若
既然	既是
不但	非但
何止	岂止
连	并
凡是	凡
除了	除去
除非	只有
若非	要不是
否则	要不
庶几	庶
如果	如其
那末	那么
因为	因
由于	鉴于
由此可见	有鉴于此
所以	因而
如上所述	总的来说
不论	无论
好歹	无论如何
只管	尽管
于是	于是乎
此外	另外
哪堪	不堪
岂	怎
是不是	是否
然	乎
等等	之类
来着	来
罢了	而已
嗨哟	哼唷
哎呀	哎哟
唉	嗳
哈哈	嘿嘿
扑哧	哧
呜呜	哇哇
哇啦	哇哇
叽叽嘎嘎	叽叽喳喳
喃喃	喁喁
咻咻	呼哧
呼噜	咕嘟
啈啈	哼
咪咪	喵
啾啾	咬咬
喔喔	喔
咕咕	咯咯
嘎嘎	呱呱
呼呼	呜呜
淅沥	滴答
刷刷	哗哗
隆隆	咕隆
烘烘	吱吱
哗哗	哗啦
冬冬	咚咚
嘡嘡	铮铮
丁零	丁丁
丁东	玲玲
丁当	锒铛
当啷	哐啷
辘辘	轧
咯噔	噔
吧唧	咕唧
咿哑	咿呀
咔嚓	吧
嘎吱	咯吱
沙沙	萧瑟
吱喽	呀
笃笃	嗒嗒
梆	砰
嗒嗒	哒
突突	怦
噼啪	啪
扑漉	拨剌
喀哒	吧嗒
刷拉	砉
刺	哧
咕咚	扑通
嘟嘟	呜
轰隆	嗡嗡
早安	早
再见	再会
失陪	少陪
慢走	好走
请问	借问
指教	赐教
候教	聆教
承蒙	承情
赏光	赏脸
打扰	打搅
劳驾	劳神
抱歉	对不起
久仰	久仰大名
久违	少见
怠慢	失敬
失迎	有失远迎
请便	听便
恭喜	恭贺
托福	借光
谢谢	多谢
不谢	不敢当
过奖	过誉
